age_of_sea_ice	year		
age_of_stratospheric_air	s		
age_of_surface_snow	day		
air_density	kg m-3		
air_potential_temperature	K	theta	13
air_pressure	Pa	plev	1
air_pressure_anomaly	Pa		26
air_pressure_at_cloud_base	Pa		
air_pressure_at_cloud_top	Pa		
air_pressure_at_convective_cloud_base	Pa		
air_pressure_at_convective_cloud_top	Pa		
air_pressure_at_freezing_level	Pa		
air_pressure_at_sea_level	Pa	psl	2 E151
air_temperature	K	ta	11 E130
air_temperature_anomaly	K		25
air_temperature_at_cloud_top	K		
air_temperature_lapse_rate	K m-1		19
air_temperature_threshold	K		
altimeter_range	m		
altimeter_range_correction_due_to_dry_troposphere	m		
altimeter_range_correction_due_to_ionosphere	m		
altimeter_range_correction_due_to_wet_troposphere	m		
altitude	m		8
altitude_at_top_of_dry_convection	m		
ambient_aerosol_particle_diameter	m		
amplitude_of_global_average_sea_level_change	m		
angle_of_emergence	degree		
angle_of_incidence	degree		
angle_of_rotation_from_east_to_x	degree		
angle_of_rotation_from_east_to_y	degree		
angle_of_rotation_from_solar_azimuth_to_platform_azimuth	degree		
angstrom_exponent_of_ambient_aerosol_in_air
alias: aerosol_angstrom_exponent
1		
area_fraction	1		
area_fraction_below_surface	1	psbg	
area_type
alias: land_cover
alias: surface_cover
1		
atmosphere_absolute_vorticity	s-1		41
atmosphere_absorption_optical_thickness_due_to_ambient_aerosol	1		
atmosphere_absorption_optical_thickness_due_to_black_carbon_ambient_aerosol	1		
atmosphere_absorption_optical_thickness_due_to_dust_ambient_aerosol	1		
atmosphere_absorption_optical_thickness_due_to_particulate_organic_matter_ambient_aerosol	1		
atmosphere_absorption_optical_thickness_due_to_seasalt_ambient_aerosol	1		
atmosphere_absorption_optical_thickness_due_to_sulfate_ambient_aerosol	1		
atmosphere_boundary_layer_thickness	m	zmla	
atmosphere_convective_available_potential_energy
alias: atmosphere_specific_convective_available_potential_energy
alias: specific_convective_available_potential_energy
J kg-1		
atmosphere_convective_available_potential_energy_wrt_surface	J kg -1		
atmosphere_convective_inhibition	J kg -1		
atmosphere_convective_inhibition_wrt_surface	J kg -1		
atmosphere_downdraft_convective_mass_flux	kg m-2 s-1		
atmosphere_dry_energy_content	J m-2		
atmosphere_dry_static_energy_content	J m-2		
atmosphere_eastward_stress_due_to_gravity_wave_drag	Pa	tauugwd	
atmosphere_energy_content	J m-2		
atmosphere_enthalpy_content	J m-2		
atmosphere_heat_diffusivity	m2 s-1		
atmosphere_horizontal_streamfunction	m2 s-1		35
atmosphere_horizontal_velocity_potential	m2 s-1		36
atmosphere_hybrid_height_coordinate	m		
atmosphere_hybrid_sigma_pressure_coordinate	1		
atmosphere_kinetic_energy_content	J m-2		
atmosphere_level_of_free_convection	m		
atmosphere_level_of_free_convection_wrt_surface	m		
atmosphere_lifting_condensation_level	m		
atmosphere_lifting_condensation_level_wrt_surface	m		
atmosphere_ln_pressure_coordinate	1		
atmosphere_mass_content_of_acetic_acid	kg m-2		
atmosphere_mass_content_of_aceto_nitrile	kg m-2		
atmosphere_mass_content_of_alkanes	kg m-2		
atmosphere_mass_content_of_alkenes	kg m-2		
atmosphere_mass_content_of_alpha_hexachlorocyclohexane	kg m-2		
atmosphere_mass_content_of_alpha_pinene	kg m-2		
atmosphere_mass_content_of_ammonia	kg m-2		
atmosphere_mass_content_of_ammonium_dry_aerosol	kg m-2		
atmosphere_mass_content_of_anthropogenic_nmvoc_expressed_as_carbon	kg m-2		
atmosphere_mass_content_of_aromatic_compounds	kg m-2		
atmosphere_mass_content_of_atomic_bromine	kg m-2		
atmosphere_mass_content_of_atomic_chlorine	kg m-2		
atmosphere_mass_content_of_atomic_nitrogen	kg m-2		
atmosphere_mass_content_of_benzene	kg m-2		
atmosphere_mass_content_of_beta_pinene	kg m-2		
atmosphere_mass_content_of_biogenic_nmvoc_expressed_as_carbon	kg m-2		
atmosphere_mass_content_of_black_carbon_dry_aerosol	kg m-2		
atmosphere_mass_content_of_bromine_chloride	kg m-2		
atmosphere_mass_content_of_bromine_monoxide	kg m-2		
atmosphere_mass_content_of_bromine_nitrate	kg m-2		
atmosphere_mass_content_of_brox_expressed_as_bromine	kg m-2		
atmosphere_mass_content_of_butane	kg m-2		
atmosphere_mass_content_of_carbon_dioxide	kg m-2		
atmosphere_mass_content_of_carbon_monoxide	kg m-2		
atmosphere_mass_content_of_carbon_tetrachloride	kg m-2		
atmosphere_mass_content_of_cfc11	kg m-2		
atmosphere_mass_content_of_cfc113	kg m-2		
atmosphere_mass_content_of_cfc113a	kg m-2		
atmosphere_mass_content_of_cfc114	kg m-2		
atmosphere_mass_content_of_cfc115	kg m-2		
atmosphere_mass_content_of_cfc12	kg m-2		
atmosphere_mass_content_of_chlorine_dioxide	kg m-2		
atmosphere_mass_content_of_chlorine_monoxide	kg m-2		
atmosphere_mass_content_of_chlorine_nitrate	kg m-2		
atmosphere_mass_content_of_cloud_condensed_water
alias: atmosphere_cloud_condensed_water_content
kg m-2	clwvi	76
atmosphere_mass_content_of_cloud_ice
alias: atmosphere_cloud_ice_content
kg m-2	clivi	58
atmosphere_mass_content_of_cloud_liquid_water
alias: atmosphere_cloud_liquid_water_content
kg m-2		
atmosphere_mass_content_of_clox_expressed_as_chlorine	kg m-2		
atmosphere_mass_content_of_convective_cloud_condensed_water
alias: atmosphere_convective_cloud_condensed_water_content
kg m-2		
atmosphere_mass_content_of_convective_cloud_liquid_water
alias: atmosphere_convective_cloud_liquid_water_content
kg m-2		
atmosphere_mass_content_of_dichlorine_peroxide	kg m-2		
atmosphere_mass_content_of_dimethyl_sulfide	kg m-2		
atmosphere_mass_content_of_dinitrogen_pentoxide	kg m-2		
atmosphere_mass_content_of_dust_dry_aerosol	kg m-2		
atmosphere_mass_content_of_ethane	kg m-2		
atmosphere_mass_content_of_ethanol	kg m-2		
atmosphere_mass_content_of_ethene	kg m-2		
atmosphere_mass_content_of_ethyne	kg m-2		
atmosphere_mass_content_of_formaldehyde	kg m-2		
atmosphere_mass_content_of_formic_acid	kg m-2		
atmosphere_mass_content_of_gaseous_divalent_mercury	kg m-2		
atmosphere_mass_content_of_gaseous_elemental_mercury	kg m-2		
atmosphere_mass_content_of_halon1202	kg m-2		
atmosphere_mass_content_of_halon1211	kg m-2		
atmosphere_mass_content_of_halon1301	kg m-2		
atmosphere_mass_content_of_halon2402	kg m-2		
atmosphere_mass_content_of_hcc140a	kg m-2		
atmosphere_mass_content_of_hcfc141b	kg m-2		
atmosphere_mass_content_of_hcfc142b	kg m-2		
atmosphere_mass_content_of_hcfc22	kg m-2		
atmosphere_mass_content_of_hexachlorobiphenyl	kg m-2		
atmosphere_mass_content_of_hox_expressed_as_hydrogen	kg m-2		
atmosphere_mass_content_of_hydrogen_bromide	kg m-2		
atmosphere_mass_content_of_hydrogen_chloride	kg m-2		
atmosphere_mass_content_of_hydrogen_cyanide	kg m-2		
atmosphere_mass_content_of_hydrogen_peroxide	kg m-2		
atmosphere_mass_content_of_hydroperoxyl_radical	kg m-2		
atmosphere_mass_content_of_hydroxyl_radical	kg m-2		
atmosphere_mass_content_of_hypobromous_acid	kg m-2		
atmosphere_mass_content_of_hypochlorous_acid	kg m-2		
atmosphere_mass_content_of_inorganic_bromine	kg m-2		
atmosphere_mass_content_of_inorganic_chlorine	kg m-2		
atmosphere_mass_content_of_isoprene	kg m-2		
atmosphere_mass_content_of_limonene	kg m-2		
atmosphere_mass_content_of_mercury_dry_aerosol	kg m-2		
atmosphere_mass_content_of_methane	kg m-2		
atmosphere_mass_content_of_methanol	kg m-2		
atmosphere_mass_content_of_methyl_bromide	kg m-2		
atmosphere_mass_content_of_methyl_chloride	kg m-2		
atmosphere_mass_content_of_methyl_hydroperoxide	kg m-2		
atmosphere_mass_content_of_methyl_peroxy_radical	kg m-2		
atmosphere_mass_content_of_molecular_hydrogen	kg m-2		
atmosphere_mass_content_of_nitrate_dry_aerosol	kg m-2		
atmosphere_mass_content_of_nitrate_radical	kg m-2		
atmosphere_mass_content_of_nitric_acid	kg m-2		
atmosphere_mass_content_of_nitric_acid_trihydrate_ambient_aerosol	kg m-2		
atmosphere_mass_content_of_nitrogen_monoxide	kg m-2		
atmosphere_mass_content_of_nitrous_acid	kg m-2		
atmosphere_mass_content_of_nitrous_oxide	kg m-2		
atmosphere_mass_content_of_nmvoc_expressed_as_carbon	kg m-2		
atmosphere_mass_content_of_nox_expressed_as_nitrogen	kg m-2		
atmosphere_mass_content_of_noy_expressed_as_nitrogen	kg m-2		
atmosphere_mass_content_of_oxygenated_hydrocarbons	kg m-2		
atmosphere_mass_content_of_ozone	kg m-2		
atmosphere_mass_content_of_particulate_organic_matter_dry_aerosol	kg m-2		
atmosphere_mass_content_of_peroxyacetyl_nitrate	kg m-2		
atmosphere_mass_content_of_peroxynitric_acid	kg m-2		
atmosphere_mass_content_of_peroxy_radicals	kg m-2		
atmosphere_mass_content_of_primary_particulate_organic_matter_dry_aerosol	kg m-2		
atmosphere_mass_content_of_propane	kg m-2		
atmosphere_mass_content_of_propene	kg m-2		
atmosphere_mass_content_of_radon	kg m-2		
atmosphere_mass_content_of_seasalt_dry_aerosol	kg m-2		
atmosphere_mass_content_of_secondary_particulate_organic_matter_dry_aerosol	kg m-2		
atmosphere_mass_content_of_sulfate
alias: atmosphere_so4_content
alias: atmosphere_sulfate_content
kg m-2		
atmosphere_mass_content_of_sulfate_ambient_aerosol
alias: atmosphere_content_of_sulfate_aerosol
kg m-2	trsult	
atmosphere_mass_content_of_sulfate_dry_aerosol	kg m-2		
atmosphere_mass_content_of_sulfate_dry_aerosol_expressed_as_sulfur
alias: atmosphere_mass_content_of_sulfate_expressed_as_sulfur_dry_aerosol
kg m-2		
atmosphere_mass_content_of_sulfur_dioxide	kg m-2		
atmosphere_mass_content_of_terpenes	kg m-2		
atmosphere_mass_content_of_toluene	kg m-2		
atmosphere_mass_content_of_volcanic_ash	kg m-2		
atmosphere_mass_content_of_water	kg m-2		
atmosphere_mass_content_of_water_in_ambient_aerosol	kg m-2		
atmosphere_mass_content_of_water_vapor
alias: atmosphere_water_vapor_content
kg m-2	prw	54
atmosphere_mass_content_of_xylene	kg m-2		
atmosphere_mass_of_air_per_unit_area	kg m-2		
atmosphere_mass_of_carbon_dioxide	kg		
atmosphere_mass_per_unit_area	kg m-2		
atmosphere_mole_content_of_ozone	mol m-2		
atmosphere_moles_of_acetic_acid	mol		
atmosphere_moles_of_aceto_nitrile	mol		
atmosphere_moles_of_alpha_hexachlorocyclohexane	mol		
atmosphere_moles_of_alpha_pinene	mol		
atmosphere_moles_of_ammonia	mol		
atmosphere_moles_of_anthropogenic_nmvoc_expressed_as_carbon	mol		
atmosphere_moles_of_atomic_bromine	mol		
atmosphere_moles_of_atomic_chlorine	mol		
atmosphere_moles_of_atomic_nitrogen	mol		
atmosphere_moles_of_benzene	mol		
atmosphere_moles_of_beta_pinene	mol		
atmosphere_moles_of_biogenic_nmvoc_expressed_as_carbon	mol		
atmosphere_moles_of_bromine_chloride	mol		
atmosphere_moles_of_bromine_monoxide	mol		
atmosphere_moles_of_bromine_nitrate	mol		
atmosphere_moles_of_brox_expressed_as_bromine	mol		
atmosphere_moles_of_butane	mol		
atmosphere_moles_of_carbon_dioxide	mol		
atmosphere_moles_of_carbon_monoxide
alias: moles_of_carbon_monoxide_in_atmosphere
mol		
atmosphere_moles_of_carbon_tetrachloride
alias: moles_of_carbon_tetrachloride_in_atmosphere
mol		
atmosphere_moles_of_cfc11
alias: moles_of_cfc11_in_atmosphere
mol		
atmosphere_moles_of_cfc113
alias: moles_of_cfc113_in_atmosphere
mol		
atmosphere_moles_of_cfc113a	mol		
atmosphere_moles_of_cfc114
alias: moles_of_cfc114_in_atmosphere
mol		
atmosphere_moles_of_cfc115
alias: moles_of_cfc115_in_atmosphere
mol		
atmosphere_moles_of_cfc12
alias: moles_of_cfc12_in_atmosphere
mol		
atmosphere_moles_of_chlorine_dioxide	mol		
atmosphere_moles_of_chlorine_monoxide	mol		
atmosphere_moles_of_chlorine_nitrate	mol		
atmosphere_moles_of_clox_expressed_as_chlorine	mol		
atmosphere_moles_of_dichlorine_peroxide	mol		
atmosphere_moles_of_dimethyl_sulfide	mol		
atmosphere_moles_of_dinitrogen_pentoxide	mol		
atmosphere_moles_of_ethane	mol		
atmosphere_moles_of_ethanol	mol		
atmosphere_moles_of_ethene	mol		
atmosphere_moles_of_ethyne	mol		
atmosphere_moles_of_formaldehyde	mol		
atmosphere_moles_of_formic_acid	mol		
atmosphere_moles_of_gaseous_divalent_mercury	mol		
atmosphere_moles_of_gaseous_elemental_mercury	mol		
atmosphere_moles_of_halon1202
alias: moles_of_halon1202_in_atmosphere
mol		
atmosphere_moles_of_halon1211
alias: moles_of_halon1211_in_atmosphere
mol		
atmosphere_moles_of_halon1301
alias: moles_of_halon1301_in_atmosphere
mol		
atmosphere_moles_of_halon2402
alias: moles_of_halon2402_in_atmosphere
mol		
atmosphere_moles_of_hcc140a
alias: moles_of_hcc140a_in_atmosphere
mol		
atmosphere_moles_of_hcfc141b	mol		
atmosphere_moles_of_hcfc142b	mol		
atmosphere_moles_of_hcfc22
alias: moles_of_hcfc22_in_atmosphere
mol		
atmosphere_moles_of_hexachlorobiphenyl	mol		
atmosphere_moles_of_hox_expressed_as_hydrogen	mol		
atmosphere_moles_of_hydrogen_bromide	mol		
atmosphere_moles_of_hydrogen_chloride	mol		
atmosphere_moles_of_hydrogen_cyanide	mol		
atmosphere_moles_of_hydrogen_peroxide	mol		
atmosphere_moles_of_hydroperoxyl_radical	mol		
atmosphere_moles_of_hydroxyl_radical	mol		
atmosphere_moles_of_hypobromous_acid	mol		
atmosphere_moles_of_hypochlorous_acid	mol		
atmosphere_moles_of_inorganic_bromine	mol		
atmosphere_moles_of_inorganic_chlorine	mol		
atmosphere_moles_of_isoprene	mol		
atmosphere_moles_of_limonene	mol		
atmosphere_moles_of_methane
alias: moles_of_methane_in_atmosphere
mol		
atmosphere_moles_of_methanol	mol		
atmosphere_moles_of_methyl_bromide
alias: moles_of_methyl_bromide_in_atmosphere
mol		
atmosphere_moles_of_methyl_chloride
alias: moles_of_methyl_chloride_in_atmosphere
mol		
atmosphere_moles_of_methyl_hydroperoxide	mol		
atmosphere_moles_of_methyl_peroxy_radical	mol		
atmosphere_moles_of_molecular_hydrogen
alias: moles_of_molecular_hydrogen_in_atmosphere
mol		
atmosphere_moles_of_nitrate_radical	mol		
atmosphere_moles_of_nitric_acid	mol		
atmosphere_moles_of_nitric_acid_trihydrate_ambient_aerosol	mol		
atmosphere_moles_of_nitrogen_dioxide	mol		
atmosphere_moles_of_nitrogen_monoxide	mol		
atmosphere_moles_of_nitrous_acid	mol		
atmosphere_moles_of_nitrous_oxide
alias: moles_of_nitrous_oxide_in_atmosphere
mol		
atmosphere_moles_of_nmvoc_expressed_as_carbon	mol		
atmosphere_moles_of_nox_expressed_as_nitrogen	mol		
atmosphere_moles_of_noy_expressed_as_nitrogen	mol		
atmosphere_moles_of_ozone	mol		
atmosphere_moles_of_peroxyacetyl_nitrate	mol		
atmosphere_moles_of_peroxynitric_acid	mol		
atmosphere_moles_of_propane	mol		
atmosphere_moles_of_propene	mol		
atmosphere_moles_of_radon	mol		
atmosphere_moles_of_sulfur_dioxide	mol		
atmosphere_moles_of_toluene	mol		
atmosphere_moles_of_water_vapor	mol		
atmosphere_moles_of_xylene	mol		
atmosphere_momentum_diffusivity	m2 s-1		
atmosphere_net_rate_of_absorption_of_longwave_energy	W m-2		
atmosphere_net_rate_of_absorption_of_shortwave_energy	W m-2		
atmosphere_net_upward_convective_mass_flux
alias: atmosphere_convective_mass_flux
kg m-2 s-1		
atmosphere_net_upward_deep_convective_mass_flux	kg m-2 s-1		
atmosphere_net_upward_shallow_convective_mass_flux	kg m-2 s-1		
atmosphere_northward_stress_due_to_gravity_wave_drag	Pa	tauvgwd	
atmosphere_number_content_of_aerosol_particles	m-2		
atmosphere_number_content_of_cloud_droplets	m-2		
atmosphere_number_content_of_ice_crystals	m-2		
atmosphere_optical_thickness_due_to_ambient_aerosol
alias: atmosphere_optical_thickness_due_to_aerosol
1		
atmosphere_optical_thickness_due_to_black_carbon_ambient_aerosol	1		
atmosphere_optical_thickness_due_to_cloud	1		
atmosphere_optical_thickness_due_to_convective_cloud	1		
atmosphere_optical_thickness_due_to_dust_ambient_aerosol	1		
atmosphere_optical_thickness_due_to_dust_dry_aerosol	1		
atmosphere_optical_thickness_due_to_particulate_organic_matter_ambient_aerosol	1		
atmosphere_optical_thickness_due_to_pm10_ambient_aerosol	1		
atmosphere_optical_thickness_due_to_pm1_ambient_aerosol	1		
atmosphere_optical_thickness_due_to_pm2p5_ambient_aerosol	1		
atmosphere_optical_thickness_due_to_seasalt_ambient_aerosol	1		
atmosphere_optical_thickness_due_to_stratiform_cloud	1		
atmosphere_optical_thickness_due_to_water_in_ambient_aerosol	1		
atmosphere_potential_energy_content	J m-2		
atmosphere_relative_vorticity	s-1		43 E138
atmosphere_sigma_coordinate	1		
atmosphere_sleve_coordinate	1		
atmosphere_stability_k_index	K		
atmosphere_stability_showalter_index	K		
atmosphere_stability_total_totals_index	K		
atmosphere_updraft_convective_mass_flux	kg m-2 s-1		
backscattering_ratio	1		
baroclinic_eastward_sea_water_velocity	m s-1		
baroclinic_northward_sea_water_velocity	m s-1		
barometric_altitude	m		
barotropic_eastward_sea_water_velocity	m s-1		
barotropic_northward_sea_water_velocity	m s-1		
barotropic_sea_water_x_velocity	m s-1		
barotropic_sea_water_y_velocity	m s-1		
baseflow_amount	kg m-2		
beaufort_wind_force	1		
bedrock_altitude	m		
bedrock_altitude_change_due_to_isostatic_adjustment	m		
bioluminescent_photon_rate_in_sea_water	s-1 m-3		
biomass_burning_carbon_flux	kg m-2 s-1		
bolus_eastward_sea_water_velocity	m s-1		
bolus_northward_sea_water_velocity	m s-1		
bolus_sea_water_x_velocity	m s-1		
bolus_sea_water_y_velocity	m s-1		
bolus_upward_sea_water_velocity	m s-1		
brightness_temperature	K		118
brightness_temperature_anomaly	K		
brunt_vaisala_frequency_in_air	s-1		
burned_area	m2		
burned_area_fraction	1		
canopy_and_surface_water_amount	kg m-2		
canopy_height	m		
canopy_temperature	K		
canopy_throughfall_flux	kg m-2 s-1		
canopy_water_amount	kg m-2		
carbon_content_of_products_of_anthropogenic_land_use_change	kg m-2		
carbon_mass_flux_into_soil_from_litter	kg m-2 s-1		
carbon_mass_flux_into_soil_from_vegetation_excluding_litter	kg m-2 s-1		
cell_area	m2		
cell_thickness	m		
change_in_atmosphere_energy_content_due_to_change_in_sigma_coordinate_wrt_surface_pressure	J m-2		
change_in_energy_content_of_atmosphere_layer_due_to_change_in_sigma_coordinate_wrt_surface_pressure	J m-2		
change_over_time_in_atmosphere_mass_content_of_water_due_to_advection
alias: change_over_time_in_atmospheric_water_content_due_to_advection
alias: change_over_time_in_atmosphere_water_content_due_to_advection
kg m-2		
change_over_time_in_sea_water_absolute_salinity	g kg-1		
change_over_time_in_sea_water_conservative_temperature	K		
change_over_time_in_sea_water_density	kg m-3		
change_over_time_in_sea_water_neutral_density	kg m-3		
change_over_time_in_sea_water_potential_density	kg m-3		
change_over_time_in_sea_water_potential_temperature	K		
change_over_time_in_sea_water_practical_salinity	1e-3		
change_over_time_in_sea_water_preformed_salinity	g kg-1		
change_over_time_in_sea_water_salinity	1e-3		
change_over_time_in_sea_water_specific_potential_enthalpy	J kg-1		
change_over_time_in_sea_water_temperature	K		
change_over_time_in_surface_snow_amount	kg m-2		
cloud_albedo	1		
cloud_area_fraction	1	clt	71 E164
cloud_area_fraction_in_atmosphere_layer	1	cl	
cloud_base_altitude	m		
cloud_ice_mixing_ratio	1		
cloud_liquid_water_mixing_ratio	1		
cloud_top_altitude	m		
compressive_strength_of_sea_ice	Pa m		
convection_time_fraction	1		
convective_cloud_area_fraction	1		72 E185
convective_cloud_area_fraction_in_atmosphere_layer	1		
convective_cloud_base_altitude	m		
convective_cloud_base_height	m		
convective_cloud_longwave_emissivity	1		
convective_cloud_top_altitude	m		
convective_cloud_top_height	m		
convective_precipitation_amount	kg m-2		63
convective_precipitation_flux	kg m-2 s-1	prc	
convective_precipitation_rate	m s-1		
convective_rainfall_amount	kg m-2		
convective_rainfall_flux	kg m-2 s-1		
convective_rainfall_rate	m s-1		
convective_snowfall_amount	kg m-2		78
convective_snowfall_flux	kg m-2 s-1		
coriolis_parameter	s-1		
correction_for_model_negative_specific_humidity	1		
depth	m		
depth_at_maximum_upward_derivative_of_sea_water_potential_temperature	m		
depth_at_shallowest_local_minimum_in_vertical_profile_of_mole_concentration_of_dissolved_molecular_oxygen_in_sea_water	m		
depth_below_geoid	m		
depth_of_isosurface_of_sea_water_potential_temperature	m		
dew_point_depression	K		18
dew_point_temperature	K		17
difference_of_air_pressure_from_model_reference	Pa		
diffuse_downwelling_shortwave_flux_in_air	W m-2		
diffuse_downwelling_shortwave_flux_in_air_assuming_clear_sky	W m-2		
dimensionless_exner_function	1		
direction_of_radial_vector_away_from_instrument	degree		
direction_of_sea_ice_displacement	degrees		
direction_of_sea_ice_velocity	degree		93
direction_of_sea_water_velocity	degree		47
divergence_of_sea_ice_velocity	s-1		98
divergence_of_wind	s-1		44 E155
downward_dry_static_energy_flux_due_to_diffusion	W m-2		
downward_eastward_momentum_flux_in_air	Pa		124
downward_eastward_momentum_flux_in_air_due_to_diffusion	Pa		
downward_eastward_stress_at_sea_ice_base	Pa		
downward_heat_flux_at_ground_level_in_snow	W m-2		
downward_heat_flux_at_ground_level_in_soil	W m-2		
downward_heat_flux_in_air	W m-2		
downward_heat_flux_in_floating_ice	W m-2		
downward_heat_flux_in_sea_ice	W m-2		
downward_heat_flux_in_soil	W m-2		
downward_northward_momentum_flux_in_air	Pa		125
downward_northward_momentum_flux_in_air_due_to_diffusion	Pa		
downward_northward_stress_at_sea_ice_base	Pa		
downward_sea_ice_basal_salt_flux	kg m-2 s-1		
downward_water_vapor_flux_in_air_due_to_diffusion	kg m-2 s-1		
downward_x_stress_at_sea_ice_base	Pa		
downward_y_stress_at_sea_ice_base	Pa		
downwelling_longwave_flux_in_air	W m-2		
downwelling_longwave_flux_in_air_assuming_clear_sky	W m-2		
downwelling_longwave_radiance_in_air	W m-2 sr-1		
downwelling_photon_flux_in_sea_water	mol m-2 s-1		
downwelling_photon_flux_per_unit_wavelength_in_sea_water
alias: downwelling_spectral_photon_flux_in_sea_water
mol m-2 s-1 m-1		
downwelling_photon_radiance_in_sea_water	mol m-2 s-1 sr-1		
downwelling_photon_radiance_per_unit_wavelength_in_sea_water
alias: downwelling_spectral_photon_radiance_in_sea_water
mol m-2 s-1 m-1 sr-1		
downwelling_photon_spherical_irradiance_in_sea_water	mol m-2 s-1		
downwelling_photon_spherical_irradiance_per_unit_wavelength_in_sea_water
alias: downwelling_spectral_photon_spherical_irradiance_in_sea_water
mol m-2 s-1 m-1		
downwelling_photosynthetic_photon_flux_in_sea_water	mol m-2 s-1		
downwelling_photosynthetic_photon_radiance_in_sea_water	mol m-2 s-1 sr-1		
downwelling_photosynthetic_photon_spherical_irradiance_in_sea_water	mol m-2 s-1		
downwelling_photosynthetic_radiance_in_sea_water	W m-2 sr-1		
downwelling_photosynthetic_radiative_flux_in_sea_water	W m-2		
downwelling_photosynthetic_spherical_irradiance_in_sea_water	W m-2		
downwelling_radiance_in_sea_water	W m-2 sr-1		
downwelling_radiance_per_unit_wavelength_in_air
alias: downwelling_spectral_radiance_in_air
W m-2 m-1 sr-1		
downwelling_radiance_per_unit_wavelength_in_sea_water
alias: downwelling_spectral_radiance_in_sea_water
W m-2 m-1 sr-1		
downwelling_radiative_flux_in_sea_water	W m-2		
downwelling_radiative_flux_per_unit_wavelength_in_air
alias: downwelling_spectral_radiative_flux_in_air
W m-2 m-1		
downwelling_radiative_flux_per_unit_wavelength_in_sea_water
alias: downwelling_spectral_radiative_flux_in_sea_water
W m-2 m-1		
downwelling_shortwave_flux_in_air	W m-2		
downwelling_shortwave_flux_in_air_assuming_clear_sky	W m-2		
downwelling_shortwave_flux_in_sea_water	W m-2		
downwelling_shortwave_radiance_in_air	W m-2 sr-1		
downwelling_spherical_irradiance_in_sea_water	W m-2		
downwelling_spherical_irradiance_per_unit_wavelength_in_sea_water
alias: downwelling_spectral_spherical_irradiance_in_sea_water
W m-2 m-1		
dry_energy_content_of_atmosphere_layer	J m-2		
dry_static_energy_content_of_atmosphere_layer	J m-2		
duration_of_sunshine	s		
dynamic_tropopause_potential_temperature	K		
eastward_atmosphere_dry_static_energy_transport_across_unit_distance	W m-1		
eastward_atmosphere_water_transport_across_unit_distance	kg s-1 m-1		
eastward_atmosphere_water_vapor_transport_across_unit_distance	kg m-1 s-1		
eastward_derivative_of_northward_sea_ice_velocity	s-1		
eastward_mass_flux_of_air	kg m-2 s-1		
eastward_momentum_flux_correction	Pa	tauucorr	
eastward_sea_ice_displacement	m		
eastward_sea_ice_velocity	m s-1		95
eastward_sea_water_velocity	m s-1		49
eastward_sea_water_velocity_assuming_no_tide	m s-1		
eastward_transformed_eulerian_mean_air_velocity
alias: eastward_transformed_eulerian_mean_velocity
m s-1		
eastward_water_vapor_flux_in_air
alias: eastward_water_vapor_flux
kg m-2 s-1		
eastward_water_vapor_transport_across_unit_distance_in_atmosphere_layer	kg m-1 s-1		
eastward_wind	m s-1	ua	33 E131
eastward_wind_shear	s-1		45
effective_radius_of_cloud_condensed_water_particles_at_cloud_top	m		
effective_radius_of_cloud_liquid_water_particle	m		
effective_radius_of_cloud_liquid_water_particle_at_liquid_water_cloud_top	m		
effective_radius_of_convective_cloud_ice_particle	m		
effective_radius_of_convective_cloud_liquid_water_particle	m		
effective_radius_of_convective_cloud_rain_particle	m		
effective_radius_of_convective_cloud_snow_particle	m		
effective_radius_of_stratiform_cloud_graupel_particle	m		
effective_radius_of_stratiform_cloud_ice_particle	m		
effective_radius_of_stratiform_cloud_liquid_water_particle	m		
effective_radius_of_stratiform_cloud_rain_particle	m		
effective_radius_of_stratiform_cloud_snow_particle	m		
enthalpy_content_of_atmosphere_layer	J m-2		
equilibrium_line_altitude	m		
equivalent_potential_temperature	K		
equivalent_pressure_of_atmosphere_ozone_content	Pa		
equivalent_reflectivity_factor	dBZ		
equivalent_temperature	K		
equivalent_thickness_at_stp_of_atmosphere_ozone_content
alias: equivalent_thickness_at_stp_of_atmosphere_o3_content
m		10
ertel_potential_vorticity	K m2 kg-1 s-1	vorpot	
fast_soil_pool_carbon_content	kg m-2		
final_air_pressure_of_lifted_parcel	Pa		
floating_ice_thickness	m		
forecast_period	s		
forecast_reference_time	s		
fractional_saturation_of_oxygen_in_sea_water	1		
freezing_level_altitude	m		
freezing_temperature_of_sea_water	K		
frozen_water_content_of_soil_layer	kg m-2		
geoid_height_above_reference_ellipsoid	m		
geopotential	m2 s-2		6 E129
geopotential_height	m	zg	7 E156
geopotential_height_anomaly	m		27
geopotential_height_at_volcanic_ash_cloud_top	m		
geostrophic_eastward_wind	m s-1		
geostrophic_northward_wind	m s-1		
global_average_sea_level_change	m		
global_average_steric_sea_level_change	m		
global_average_thermosteric_sea_level_change	m		
grid_latitude	degree		
grid_longitude	degree		
gross_primary_productivity_of_biomass_expressed_as_carbon
alias: gross_primary_productivity_of_carbon
kg m-2 s-1		
harmonic_period	s		
heat_flux_correction	W m-2	hfcorr	
heat_flux_into_sea_water_due_to_freezing_of_frazil_ice	Wm-2		
heat_flux_into_sea_water_due_to_iceberg_thermodynamics	W m-2		
heat_flux_into_sea_water_due_to_newtonian_relaxation	W m-2		
heat_flux_into_sea_water_due_to_sea_ice_thermodynamics	W m-2		
heat_flux_into_sea_water_due_to_snow_thermodynamics	W m-2		
height	m	zh	
height_above_reference_ellipsoid	m		
height_above_sea_floor	m		
height_at_cloud_top	m		
heterotrophic_respiration_carbon_flux	kg m-2 s-1		
high_type_cloud_area_fraction	1		
histogram_of_backscattering_ratio_over_height_above_reference_ellipsoid	1		
histogram_of_equivalent_reflectivity_factor_over_height_above_reference_ellipsoid	1		
horizontal_atmosphere_dry_energy_transport	W m-2		
horizontal_dry_energy_transport_in_atmosphere_layer	W m-2		
humidity_mixing_ratio	1		53
integral_of_air_temperature_deficit_wrt_time	K s		
integral_of_air_temperature_excess_wrt_time	K s		
integral_of_sea_ice_temperature_wrt_depth_expressed_as_heat_content	J m-2		
integral_of_sea_water_potential_temperature_wrt_depth_expressed_as_heat_content	J m-2		
integral_of_sea_water_temperature_wrt_depth_in_ocean_layer	K m		
integral_of_surface_downward_eastward_stress_wrt_time	Pa s		
integral_of_surface_downward_latent_heat_flux_wrt_time	W s m-2		
integral_of_surface_downward_northward_stress_wrt_time	Pa s		
integral_of_surface_downward_sensible_heat_flux_wrt_time	W s m-2		
integral_of_surface_downwelling_longwave_flux_in_air_wrt_time	W s m-2		
integral_of_surface_downwelling_shortwave_flux_in_air_wrt_time	W s m-2		
integral_of_surface_net_downward_longwave_flux_wrt_time	W s m-2		
integral_of_surface_net_downward_shortwave_flux_wrt_time	W s m-2		
integral_of_toa_net_downward_shortwave_flux_wrt_time	W s m-2		
integral_of_toa_outgoing_longwave_flux_wrt_time	W s m-2		
integral_wrt_depth_of_tendency_of_sea_water_alkalinity_expressed_as_mole_equivalent	mol m-2 s-1		
integral_wrt_depth_of_tendency_of_sea_water_alkalinity_expressed_as_mole_equivalent_due_to_biological_processes	mol m-2 s-1		
isccp_cloud_area_fraction	1	clisccp	
isotropic_longwave_radiance_in_air
alias: longwave_radiance
W m-2 sr-1		
isotropic_radiance_per_unit_wavelength_in_air
alias: isotropic_spectral_radiance_in_air
alias: spectral_radiance
W m-2 m-1 sr-1		
isotropic_shortwave_radiance_in_air
alias: shortwave_radiance
W m-2 sr-1		
kinetic_energy_content_of_atmosphere_layer	J m-2		
kinetic_energy_dissipation_in_atmosphere_boundary_layer
alias: dissipation_in_atmosphere_boundary_layer
W m-2		E145
lagrangian_tendency_of_air_pressure
alias: omega
alias: vertical_air_velocity_expressed_as_tendency_of_pressure
Pa s-1	wap	39 E135
lagrangian_tendency_of_atmosphere_sigma_coordinate
alias: upward_air_velocity_expressed_as_tendency_of_sigma
alias: vertical_air_velocity_expressed_as_tendency_of_sigma
s-1		38
land_area_fraction	1	sftlf	81
land_binary_mask	1		E172
land_cover_lccs			
land_ice_area_fraction	1	sftgif	
land_ice_basal_melt_rate	m s-1		
land_ice_basal_x_velocity	m s-1		
land_ice_basal_y_velocity	m s-1		
land_ice_calving_rate	m s-1		
land_ice_lwe_basal_melt_rate	m s-1		
land_ice_lwe_calving_rate	m s-1		
land_ice_lwe_surface_specific_mass_balance_rate
alias: land_ice_lwe_surface_specific_mass_balance
m s-1		
land_ice_sigma_coordinate	1		
land_ice_surface_specific_mass_balance_flux	kg m-2 s-1		
land_ice_surface_specific_mass_balance_rate
alias: land_ice_surface_specific_mass_balance
m s-1		
land_ice_temperature	K		
land_ice_thickness	m		
land_ice_vertical_mean_x_velocity	m s-1		
land_ice_vertical_mean_y_velocity	m s-1		
land_ice_x_velocity	m s-1		
land_ice_y_velocity	m s-1		
latitude	degree_north	latitude	
leaf_area_index	1		
leaf_carbon_content	kg m-2		
liquid_water_content_of_permafrost_layer	kg m-2		
liquid_water_content_of_soil_layer	kg m-2		
liquid_water_content_of_surface_snow
alias: liquid_water_content_of_snow_layer
kg m-2		
litter_carbon_content	kg m-2		
litter_carbon_flux	kg m-2 s-1		
longitude	degree_east	longitude	
low_type_cloud_area_fraction	1		
lwe_convective_precipitation_rate	m s-1		
lwe_convective_snowfall_rate	m s-1		
lwe_precipitation_rate	m s-1		
lwe_snowfall_rate	m s-1		
lwe_stratiform_precipitation_rate
alias: lwe_large_scale_precipitation_rate
m s-1		
lwe_stratiform_snowfall_rate
alias: lwe_large_scale_snowfall_rate
m s-1		
lwe_thickness_of_atmosphere_mass_content_of_water_vapor
alias: lwe_thickness_of_atmosphere_water_vapor_content
m		E137
lwe_thickness_of_canopy_water_amount	m		
lwe_thickness_of_convective_precipitation_amount	m		E143
lwe_thickness_of_convective_snowfall_amount	m		
lwe_thickness_of_frozen_water_content_of_soil_layer	m		
lwe_thickness_of_moisture_content_of_soil_layer	m		
lwe_thickness_of_precipitation_amount	m		
lwe_thickness_of_snowfall_amount	m		E144
lwe_thickness_of_soil_moisture_content	m		E140
lwe_thickness_of_stratiform_precipitation_amount
alias: lwe_thickness_of_large_scale_precipitation_amount
m		E142
lwe_thickness_of_stratiform_snowfall_amount
alias: lwe_thickness_of_large_scale_snowfall_amount
m		
lwe_thickness_of_surface_snow_amount	m		E141
lwe_thickness_of_water_evaporation_amount	m		E182
lwe_water_evaporation_rate	m s-1		
magnitude_of_derivative_of_position_wrt_model_level_number	m		
magnitude_of_derivative_of_position_wrt_x_coordinate_index	m		
magnitude_of_derivative_of_position_wrt_y_coordinate_index	m		
magnitude_of_heat_flux_in_sea_water_due_to_advection	W m-2		
magnitude_of_sea_ice_displacement
alias: sea_ice_displacement
m		
magnitude_of_surface_downward_stress	Pa		
mass_concentration_of_acetic_acid_in_air	kg m-3		
mass_concentration_of_aceto_nitrile_in_air	kg m-3		
mass_concentration_of_alkanes_in_air	kg m-3		
mass_concentration_of_alkenes_in_air	kg m-3		
mass_concentration_of_alpha_hexachlorocyclohexane_in_air	kg m-3		
mass_concentration_of_alpha_pinene_in_air	kg m-3		
mass_concentration_of_ammonia_in_air	kg m-3		
mass_concentration_of_ammonium_dry_aerosol_in_air	kg m-3		
mass_concentration_of_anthropogenic_nmvoc_expressed_as_carbon_in_air	kg m-3		
mass_concentration_of_aromatic_compounds_in_air	kg m-3		
mass_concentration_of_atomic_bromine_in_air	kg m-3		
mass_concentration_of_atomic_chlorine_in_air	kg m-3		
mass_concentration_of_atomic_nitrogen_in_air	kg m-3		
mass_concentration_of_benzene_in_air	kg m-3		
mass_concentration_of_beta_pinene_in_air	kg m-3		
mass_concentration_of_biogenic_nmvoc_expressed_as_carbon_in_air	kg m-3		
mass_concentration_of_biomass_burning_dry_aerosol_in_air	kg m-3		
mass_concentration_of_black_carbon_dry_aerosol_in_air	kg m-3		
mass_concentration_of_bromine_chloride_in_air	kg m-3		
mass_concentration_of_bromine_monoxide_in_air	kg m-3		
mass_concentration_of_bromine_nitrate_in_air	kg m-3		
mass_concentration_of_brox_expressed_as_bromine_in_air	kg m-3		
mass_concentration_of_butane_in_air	kg m-3		
mass_concentration_of_calcareous_phytoplankton_expressed_as_chlorophyll_in_sea_water	kg m-3		
mass_concentration_of_carbon_dioxide_in_air	kg m-3		
mass_concentration_of_carbon_monoxide_in_air	kg m-3		
mass_concentration_of_carbon_tetrachloride_in_air	kg m-3		
mass_concentration_of_cfc113a_in_air	kg m-3		
mass_concentration_of_cfc113_in_air	kg m-3		
mass_concentration_of_cfc114_in_air	kg m-3		
mass_concentration_of_cfc115_in_air	kg m-3		
mass_concentration_of_cfc11_in_air	kg m-3		
mass_concentration_of_cfc12_in_air	kg m-3		
mass_concentration_of_chlorine_dioxide_in_air	kg m-3		
mass_concentration_of_chlorine_monoxide_in_air	kg m-3		
mass_concentration_of_chlorine_nitrate_in_air	kg m-3		
mass_concentration_of_chlorophyll_a_in_sea_water	kg m-3		
mass_concentration_of_chlorophyll_in_sea_water
alias: chlorophyll_concentration_in_sea_water
alias: concentration_of_chlorophyll_in_sea_water
kg m-3		
mass_concentration_of_cloud_liquid_water_in_air	kg m-3		
mass_concentration_of_clox_expressed_as_chlorine_in_air	kg m-3		
mass_concentration_of_coarse_mode_ambient_aerosol_in_air	kg m-3		
mass_concentration_of_condensed_water_in_soil	kg m-3		
mass_concentration_of_diatoms_expressed_as_carbon_in_sea_water	kg m-3		
mass_concentration_of_diatoms_expressed_as_chlorophyll_in_sea_water	kg m-3		
mass_concentration_of_diatoms_expressed_as_nitrogen_in_sea_water	kg m-3		
mass_concentration_of_diazotrophs_expressed_as_chlorophyll_in_sea_water	kg m-3		
mass_concentration_of_dichlorine_peroxide_in_air	kg m-3		
mass_concentration_of_dimethyl_sulfide_in_air	kg m-3		
mass_concentration_of_dinitrogen_pentoxide_in_air	kg m-3		
mass_concentration_of_drizzle_in_air	kg m-3		
mass_concentration_of_dust_dry_aerosol_in_air	kg m-3		
mass_concentration_of_ethane_in_air	kg m-3		
mass_concentration_of_ethanol_in_air	kg m-3		
mass_concentration_of_ethene_in_air	kg m-3		
mass_concentration_of_ethyne_in_air	kg m-3		
mass_concentration_of_flagellates_expressed_as_carbon_in_sea_water	kg m-3		
mass_concentration_of_flagellates_expressed_as_nitrogen_in_sea_water	kg m-3		
mass_concentration_of_formaldehyde_in_air	kg m-3		
mass_concentration_of_formic_acid_in_air	kg m-3		
mass_concentration_of_gaseous_divalent_mercury_in_air	kg m-3		
mass_concentration_of_gaseous_elemental_mercury_in_air	kg m-3		
mass_concentration_of_halon1202_in_air	kg m-3		
mass_concentration_of_halon1211_in_air	kg m-3		
mass_concentration_of_halon1301_in_air	kg m-3		
mass_concentration_of_halon2402_in_air	kg m-3		
mass_concentration_of_hcc140a_in_air	kg m-3		
mass_concentration_of_hcfc141b_in_air	kg m-3		
mass_concentration_of_hcfc142b_in_air	kg m-3		
mass_concentration_of_hcfc22_in_air	kg m-3		
mass_concentration_of_hexachlorobiphenyl_in_air	kg m-3		
mass_concentration_of_hox_expressed_as_hydrogen_in_air	kg m-3		
mass_concentration_of_hydrogen_bromide_in_air	kg m-3		
mass_concentration_of_hydrogen_chloride_in_air	kg m-3		
mass_concentration_of_hydrogen_cyanide_in_air	kg m-3		
mass_concentration_of_hydrogen_peroxide_in_air	kg m-3		
mass_concentration_of_hydroperoxyl_radical_in_air	kg m-3		
mass_concentration_of_hydroxyl_radical_in_air	kg m-3		
mass_concentration_of_hypobromous_acid_in_air	kg m-3		
mass_concentration_of_hypochlorous_acid_in_air	kg m-3		
mass_concentration_of_inorganic_bromine_in_air	kg m-3		
mass_concentration_of_inorganic_chlorine_in_air	kg m-3		
mass_concentration_of_inorganic_nitrogen_in_sea_water	kg m-3		
mass_concentration_of_isoprene_in_air	kg m-3		
mass_concentration_of_limonene_in_air	kg m-3		
mass_concentration_of_liquid_water_in_air	kg m-3		
mass_concentration_of_mercury_dry_aerosol_in_air	kg m-3		
mass_concentration_of_methane_in_air	kg m-3		
mass_concentration_of_methanol_in_air	kg m-3		
mass_concentration_of_methyl_bromide_in_air	kg m-3		
mass_concentration_of_methyl_chloride_in_air	kg m-3		
mass_concentration_of_methyl_hydroperoxide_in_air	kg m-3		
mass_concentration_of_methyl_peroxy_radical_in_air	kg m-3		
mass_concentration_of_miscellaneous_phytoplankton_expressed_as_chlorophyll_in_sea_water	kg m-3		
mass_concentration_of_molecular_hydrogen_in_air	kg m-3		
mass_concentration_of_nitrate_dry_aerosol_in_air	kg m-3		
mass_concentration_of_nitrate_radical_in_air	kg m-3		
mass_concentration_of_nitric_acid_in_air	kg m-3		
mass_concentration_of_nitric_acid_trihydrate_ambient_aerosol_in_air	kg m-3		
mass_concentration_of_nitrogen_dioxide_in_air	kg m-3		
mass_concentration_of_nitrogen_monoxide_in_air	kg m-3		
mass_concentration_of_nitrous_acid_in_air	kg m-3		
mass_concentration_of_nitrous_oxide_in_air	kg m-3		
mass_concentration_of_nmvoc_expressed_as_carbon_in_air	kg m-3		
mass_concentration_of_nox_expressed_as_nitrogen_in_air	kg m-3		
mass_concentration_of_noy_expressed_as_nitrogen_in_air	kg m-3		
mass_concentration_of_organic_detritus_expressed_as_carbon_in_sea_water	kg m-3		
mass_concentration_of_organic_detritus_expressed_as_nitrogen_in_sea_water	kg m-3		
mass_concentration_of_oxygenated_hydrocarbons_in_air	kg m-3		
mass_concentration_of_oxygen_in_sea_water	kg m-3		
mass_concentration_of_ozone_in_air	kg m-3		
mass_concentration_of_particulate_organic_matter_dry_aerosol_in_air	kg m-3		
mass_concentration_of_peroxyacetyl_nitrate_in_air	kg m-3		
mass_concentration_of_peroxynitric_acid_in_air	kg m-3		
mass_concentration_of_peroxy_radicals_in_air	kg m-3		
mass_concentration_of_phosphate_in_sea_water	kg m-3		
mass_concentration_of_phytoplankton_expressed_as_chlorophyll_in_sea_water	kg m-3		
mass_concentration_of_picophytoplankton_expressed_as_chlorophyll_in_sea_water	kg m-3		
mass_concentration_of_pm10_ambient_aerosol_in_air	kg m-3		
mass_concentration_of_pm1_ambient_aerosol_in_air	kg m-3		
mass_concentration_of_pm2p5_ambient_aerosol_in_air	kg m-3		
mass_concentration_of_primary_particulate_organic_matter_dry_aerosol_in_air	kg m-3		
mass_concentration_of_propane_in_air	kg m-3		
mass_concentration_of_propene_in_air	kg m-3		
mass_concentration_of_radon_in_air	kg m-3		
mass_concentration_of_rain_in_air	kg m-3		
mass_concentration_of_seasalt_dry_aerosol_in_air	kg m-3		
mass_concentration_of_secondary_particulate_organic_matter_dry_aerosol_in_air	kg m-3		
mass_concentration_of_silicate_in_sea_water	kg m-3		
mass_concentration_of_sulfate_ambient_aerosol_in_air
alias: mass_concentration_of_sulfate_aerosol_in_air
kg m-3	trsul	
mass_concentration_of_sulfate_dry_aerosol_in_air	kg m-3		
mass_concentration_of_sulfur_dioxide_in_air	kg m-3		
mass_concentration_of_suspended_matter_in_sea_water
alias: concentration_of_suspended_matter_in_sea_water
kg m-3		
mass_concentration_of_terpenes_in_air	kg m-3		
mass_concentration_of_toluene_in_air	kg m-3		
mass_concentration_of_water_in_ambient_aerosol_in_air	kg m-3		
mass_concentration_of_water_vapor_in_air	kg m-3		
mass_concentration_of_xylene_in_air	kg m-3		
mass_content_of_cloud_condensed_water_in_atmosphere_layer
alias: cloud_condensed_water_content_of_atmosphere_layer
kg m-2		
mass_content_of_cloud_ice_in_atmosphere_layer
alias: cloud_ice_content_of_atmosphere_layer
kg m-2		
mass_content_of_cloud_liquid_water_in_atmosphere_layer
alias: cloud_liquid_water_content_of_atmosphere_layer
kg m-2		
mass_content_of_water_in_atmosphere_layer
alias: water_content_of_atmosphere_layer
kg m-2		
mass_content_of_water_vapor_in_atmosphere_layer
alias: water_vapor_content_of_atmosphere_layer
kg m-2		
mass_fraction_of_acetic_acid_in_air	1		
mass_fraction_of_aceto_nitrile_in_air	1		
mass_fraction_of_alkanes_in_air	1		
mass_fraction_of_alkenes_in_air	1		
mass_fraction_of_alpha_hexachlorocyclohexane_in_air	1		
mass_fraction_of_alpha_pinene_in_air	1		
mass_fraction_of_ammonia_in_air	1		
mass_fraction_of_ammonium_dry_aerosol_in_air	1		
mass_fraction_of_anthropogenic_nmvoc_expressed_as_carbon_in_air	1		
mass_fraction_of_aromatic_compounds_in_air	1		
mass_fraction_of_atomic_bromine_in_air	1		
mass_fraction_of_atomic_chlorine_in_air	1		
mass_fraction_of_atomic_nitrogen_in_air	1		
mass_fraction_of_benzene_in_air	1		
mass_fraction_of_beta_pinene_in_air	1		
mass_fraction_of_biogenic_nmvoc_expressed_as_carbon_in_air	1		
mass_fraction_of_black_carbon_dry_aerosol_in_air	1		
mass_fraction_of_bromine_chloride_in_air	1		
mass_fraction_of_bromine_monoxide_in_air	1		
mass_fraction_of_bromine_nitrate_in_air	1		
mass_fraction_of_brox_expressed_as_bromine_in_air	1		
mass_fraction_of_butane_in_air	1		
mass_fraction_of_carbon_dioxide_in_air	1		
mass_fraction_of_carbon_monoxide_in_air	1		
mass_fraction_of_carbon_tetrachloride_in_air	1		
mass_fraction_of_cfc113a_in_air	1		
mass_fraction_of_cfc113_in_air	1		
mass_fraction_of_cfc114_in_air	1		
mass_fraction_of_cfc115_in_air	1		
mass_fraction_of_cfc11_in_air	1		
mass_fraction_of_cfc12_in_air	1		
mass_fraction_of_chlorine_dioxide_in_air	1		
mass_fraction_of_chlorine_monoxide_in_air	1		
mass_fraction_of_chlorine_nitrate_in_air	1		
mass_fraction_of_chlorophyll_a_in_sea_water	1		
mass_fraction_of_cloud_condensed_water_in_air	1		
mass_fraction_of_cloud_ice_in_air	1	cli	
mass_fraction_of_cloud_liquid_water_in_air	1	clw	
mass_fraction_of_clox_expressed_as_chlorine_in_air	1		
mass_fraction_of_convective_cloud_condensed_water_in_air
alias: mass_fraction_of_convective_condensed_water_in_air
1		
mass_fraction_of_convective_cloud_ice_in_air	1		
mass_fraction_of_convective_cloud_liquid_water_in_air	1		
mass_fraction_of_dichlorine_peroxide_in_air	1		
mass_fraction_of_dimethyl_sulfide_in_air	1		
mass_fraction_of_dinitrogen_pentoxide_in_air	1		
mass_fraction_of_dust_dry_aerosol_in_air	1		
mass_fraction_of_ethane_in_air	1		
mass_fraction_of_ethanol_in_air	1		
mass_fraction_of_ethene_in_air	1		
mass_fraction_of_ethyne_in_air	1		
mass_fraction_of_formaldehyde_in_air	1		
mass_fraction_of_formic_acid_in_air	1		
mass_fraction_of_frozen_water_in_soil_moisture	1		
mass_fraction_of_gaseous_divalent_mercury_in_air	1		
mass_fraction_of_gaseous_elemental_mercury_in_air	1		
mass_fraction_of_graupel_in_air	1		
mass_fraction_of_halon1202_in_air	1		
mass_fraction_of_halon1211_in_air	1		
mass_fraction_of_halon1301_in_air	1		
mass_fraction_of_halon2402_in_air	1		
mass_fraction_of_hcc140a_in_air	1		
mass_fraction_of_hcfc141b_in_air	1		
mass_fraction_of_hcfc142b_in_air	1		
mass_fraction_of_hcfc22_in_air	1		
mass_fraction_of_hexachlorobiphenyl_in_air	1		
mass_fraction_of_hox_expressed_as_hydrogen_in_air	1		
mass_fraction_of_hydrogen_bromide_in_air	1		
mass_fraction_of_hydrogen_chloride_in_air	1		
mass_fraction_of_hydrogen_cyanide_in_air	1		
mass_fraction_of_hydrogen_peroxide_in_air	1		
mass_fraction_of_hydroperoxyl_radical_in_air	1		
mass_fraction_of_hydroxyl_radical_in_air	1		
mass_fraction_of_hypobromous_acid_in_air	1		
mass_fraction_of_hypochlorous_acid_in_air	1		
mass_fraction_of_inorganic_bromine_in_air	1		
mass_fraction_of_inorganic_chlorine_in_air	1		
mass_fraction_of_isoprene_in_air	1		
mass_fraction_of_limonene_in_air	1		
mass_fraction_of_mercury_dry_aerosol_in_air	1		
mass_fraction_of_methane_in_air	1		
mass_fraction_of_methanol_in_air	1		
mass_fraction_of_methyl_bromide_in_air	1		
mass_fraction_of_methyl_chloride_in_air	1		
mass_fraction_of_methyl_hydroperoxide_in_air	1		
mass_fraction_of_methyl_peroxy_radical_in_air	1		
mass_fraction_of_molecular_hydrogen_in_air	1		
mass_fraction_of_nitrate_dry_aerosol_in_air	1		
mass_fraction_of_nitrate_radical_in_air	1		
mass_fraction_of_nitric_acid_in_air	1		
mass_fraction_of_nitric_acid_trihydrate_ambient_aerosol_in_air	1		
mass_fraction_of_nitrogen_dioxide_in_air	1		
mass_fraction_of_nitrogen_monoxide_in_air	1		
mass_fraction_of_nitrous_acid_in_air	1		
mass_fraction_of_nitrous_oxide_in_air	1		
mass_fraction_of_nmvoc_expressed_as_carbon_in_air	1		
mass_fraction_of_nox_expressed_as_nitrogen_in_air	1		
mass_fraction_of_noy_expressed_as_nitrogen_in_air	1		
mass_fraction_of_oxygenated_hydrocarbons_in_air	1		
mass_fraction_of_ozone_in_air
alias: mass_fraction_of_o3_in_air
1		
mass_fraction_of_particulate_organic_matter_dry_aerosol_in_air	1		
mass_fraction_of_peroxyacetyl_nitrate_in_air	1		
mass_fraction_of_peroxynitric_acid_in_air	1		
mass_fraction_of_peroxy_radicals_in_air	1		
mass_fraction_of_pm10_ambient_aerosol_in_air
alias: mass_fraction_of_pm10_aerosol_in_air
1		
mass_fraction_of_pm1_ambient_aerosol_in_air
alias: mass_fraction_of_pm1_aerosol_in_air
1		
mass_fraction_of_pm2p5_ambient_aerosol_in_air
alias: mass_fraction_of_pm2p5_aerosol_in_air
1		
mass_fraction_of_precipitation_in_air	1		
mass_fraction_of_primary_particulate_organic_matter_dry_aerosol_in_air	1		
mass_fraction_of_propane_in_air	1		
mass_fraction_of_propene_in_air	1		
mass_fraction_of_radon_in_air	1		
mass_fraction_of_rain_in_air	1		
mass_fraction_of_seasalt_dry_aerosol_in_air	1		
mass_fraction_of_secondary_particulate_organic_matter_dry_aerosol_in_air	1		
mass_fraction_of_snow_in_air	1		
mass_fraction_of_stratiform_cloud_ice_in_air	1		
mass_fraction_of_stratiform_cloud_liquid_water_in_air	1		
mass_fraction_of_sulfate_dry_aerosol_in_air	1		
mass_fraction_of_sulfur_dioxide_in_air	1		
mass_fraction_of_sulfuric_acid_in_air	1		
mass_fraction_of_terpenes_in_air	1		
mass_fraction_of_toluene_in_air	1		
mass_fraction_of_unfrozen_water_in_soil_moisture	1		
mass_fraction_of_water_in_air	1		
mass_fraction_of_water_in_ambient_aerosol_in_air	1		
mass_fraction_of_xylene_in_air	1		
medium_soil_pool_carbon_content	kg m-2		
medium_type_cloud_area_fraction	1		
minimum_depth_of_aragonite_undersaturation_in_sea_water	m		
minimum_depth_of_calcite_undersaturation_in_sea_water	m		
minus_one_times_surface_upwelling_longwave_flux_in_air	W m-2		
minus_one_times_surface_upwelling_shortwave_flux_in_air	W m-2		
minus_one_times_toa_outgoing_shortwave_flux	W m-2		
minus_one_times_water_flux_into_sea_water_from_rivers	kg m-2 s-1		
miscellaneous_living_matter_carbon_content	kg m-2		
model_level_number	1	lev	
model_level_number_at_base_of_ocean_mixed_layer_defined_by_sigma_theta	1		
model_level_number_at_convective_cloud_base	1		
model_level_number_at_convective_cloud_top	1		
model_level_number_at_sea_floor	1		
model_level_number_at_top_of_atmosphere_boundary_layer	1		
moisture_content_of_soil_layer	kg m-2	mrsos	
moisture_content_of_soil_layer_at_field_capacity	kg m-2	mrsofcs	
mole_concentration_of_acetic_acid_in_air	mol m-3		
mole_concentration_of_aceto_nitrile_in_air	mol m-3		
mole_concentration_of_alpha_hexachlorocyclohexane_in_air	mol m-3		
mole_concentration_of_alpha_pinene_in_air	mol m-3		
mole_concentration_of_ammonia_in_air	mol m-3		
mole_concentration_of_ammonium_in_sea_water	mol m-3		
mole_concentration_of_anthropogenic_nmvoc_expressed_as_carbon_in_air	mol m-3		
mole_concentration_of_aragonite_expressed_as_carbon_in_sea_water	mol m-3		
mole_concentration_of_aragonite_expressed_as_carbon_in_sea_water_at_saturation	mol m-3		
mole_concentration_of_atomic_bromine_in_air	mol m-3		
mole_concentration_of_atomic_chlorine_in_air	mol m-3		
mole_concentration_of_atomic_nitrogen_in_air	mol m-3		
mole_concentration_of_bacteria_expressed_as_carbon_in_sea_water	mol m-3		
mole_concentration_of_benzene_in_air	mol m-3		
mole_concentration_of_beta_pinene_in_air	mol m-3		
mole_concentration_of_biogenic_nmvoc_expressed_as_carbon_in_air	mol m-3		
mole_concentration_of_bromine_chloride_in_air	mol m-3		
mole_concentration_of_bromine_monoxide_in_air	mol m-3		
mole_concentration_of_bromine_nitrate_in_air	mol m-3		
mole_concentration_of_brox_expressed_as_bromine_in_air	mol m-3		
mole_concentration_of_butane_in_air	mol m-3		
mole_concentration_of_calcareous_phytoplankton_expressed_as_carbon_in_sea_water	mol m-3		
mole_concentration_of_calcite_expressed_as_carbon_in_sea_water	mol m-3		
mole_concentration_of_calcite_expressed_as_carbon_in_sea_water_at_saturation	mol m-3		
mole_concentration_of_carbonate_expressed_as_carbon_in_sea_water	mol m-3		
mole_concentration_of_carbon_dioxide_in_air	mol m-3		
mole_concentration_of_carbon_monoxide_in_air	mol m-3		
mole_concentration_of_carbon_tetrachloride_in_air	mol m-3		
mole_concentration_of_cfc113a_in_air	mol m-3		
mole_concentration_of_cfc113_in_air	mol m-3		
mole_concentration_of_cfc114_in_air	mol m-3		
mole_concentration_of_cfc115_in_air	mol m-3		
mole_concentration_of_cfc11_in_air	mol m-3		
mole_concentration_of_cfc12_in_air	mol m-3		
mole_concentration_of_chlorine_dioxide_in_air	mol m-3		
mole_concentration_of_chlorine_monoxide_in_air	mol m-3		
mole_concentration_of_chlorine_nitrate_in_air	mol m-3		
mole_concentration_of_clox_expressed_as_chlorine_in_air	mol m-3		
mole_concentration_of_diatoms_expressed_as_carbon_in_sea_water	mol m-3		
mole_concentration_of_diatoms_expressed_as_nitrogen_in_sea_water
alias: mole_concentration_of_diatoms_in_sea_water_expressed_as_nitrogen
mol m-3		
mole_concentration_of_diazotrophs_expressed_as_carbon_in_sea_water	mol m-3		
mole_concentration_of_dichlorine_peroxide_in_air	mol m-3		
mole_concentration_of_dimethyl_sulfide_in_air	mol m-3		
mole_concentration_of_dimethyl_sulfide_in_sea_water	mol m-3		
mole_concentration_of_dinitrogen_pentoxide_in_air	mol m-3		
mole_concentration_of_dissolved_inorganic_carbon_in_sea_water	mol m-3		
mole_concentration_of_dissolved_iron_in_sea_water	mol m-3		
mole_concentration_of_dissolved_molecular_oxygen_in_sea_water	mol m-3		
mole_concentration_of_dissolved_molecular_oxygen_in_sea_water_at_shallowest_local_minimum_in_vertical_profile	mol m-3		
mole_concentration_of_dissolved_organic_carbon_in_sea_water	mol m-3		
mole_concentration_of_ethane_in_air	mol m-3		
mole_concentration_of_ethanol_in_air	mol m-3		
mole_concentration_of_ethene_in_air	mol m-3		
mole_concentration_of_ethyne_in_air	mol m-3		
mole_concentration_of_formaldehyde_in_air	mol m-3		
mole_concentration_of_formic_acid_in_air	mol m-3		
mole_concentration_of_gaseous_divalent_mercury_in_air	mol m-3		
mole_concentration_of_gaseous_elemental_mercury_in_air	mol m-3		
mole_concentration_of_halon1202_in_air	mol m-3		
mole_concentration_of_halon1211_in_air	mol m-3		
mole_concentration_of_halon1301_in_air	mol m-3		
mole_concentration_of_halon2402_in_air	mol m-3		
mole_concentration_of_hcc140a_in_air	mol m-3		
mole_concentration_of_hcfc141b_in_air	mol m-3		
mole_concentration_of_hcfc142b_in_air	mol m-3		
mole_concentration_of_hcfc22_in_air	mol m-3		
mole_concentration_of_hexachlorobiphenyl_in_air	mol m-3		
mole_concentration_of_hox_expressed_as_hydrogen_in_air	mol m-3		
mole_concentration_of_hydrogen_bromide_in_air	mol m-3		
mole_concentration_of_hydrogen_chloride_in_air	mol m-3		
mole_concentration_of_hydrogen_cyanide_in_air	mol m-3		
mole_concentration_of_hydrogen_peroxide_in_air	mol m-3		
mole_concentration_of_hydroperoxyl_radical_in_air	mol m-3		
mole_concentration_of_hydroxyl_radical_in_air	mol m-3		
mole_concentration_of_hypobromous_acid_in_air	mol m-3		
mole_concentration_of_hypochlorous_acid_in_air	mol m-3		
mole_concentration_of_inorganic_bromine_in_air	mol m-3		
mole_concentration_of_inorganic_chlorine_in_air	mol m-3		
mole_concentration_of_isoprene_in_air	mol m-3		
mole_concentration_of_limonene_in_air	mol m-3		
mole_concentration_of_mesozooplankton_expressed_as_carbon_in_sea_water	mol m-3		
mole_concentration_of_mesozooplankton_expressed_as_nitrogen_in_sea_water
alias: mole_concentration_of_mesozooplankton_in_sea_water_expressed_as_nitrogen
mol m-3		
mole_concentration_of_methane_in_air	mol m-3		
mole_concentration_of_methanol_in_air	mol m-3		
mole_concentration_of_methyl_bromide_in_air	mol m-3		
mole_concentration_of_methyl_chloride_in_air	mol m-3		
mole_concentration_of_methyl_hydroperoxide_in_air	mol m-3		
mole_concentration_of_methyl_peroxy_radical_in_air	mol m-3		
mole_concentration_of_microzooplankton_expressed_as_carbon_in_sea_water	mol m-3		
mole_concentration_of_microzooplankton_expressed_as_nitrogen_in_sea_water
alias: mole_concentration_of_microzooplankton_in_sea_water_expressed_as_nitrogen
mol m-3		
mole_concentration_of_miscellaneous_phytoplankton_expressed_as_carbon_in_sea_water	mol m-3		
mole_concentration_of_miscellaneous_zooplankton_expressed_as_carbon_in_sea_water	mol m-3		
mole_concentration_of_molecular_hydrogen_in_air	mol m-3		
mole_concentration_of_nitrate_and_nitrite_in_sea_water	mol m-3		
mole_concentration_of_nitrate_in_sea_water	mol m-3		
mole_concentration_of_nitrate_radical_in_air	mol m-3		
mole_concentration_of_nitric_acid_in_air	mol m-3		
mole_concentration_of_nitric_acid_trihydrate_ambient_aerosol_in_air	mol m-3		
mole_concentration_of_nitrite_in_sea_water	mol m-3		
mole_concentration_of_nitrogen_dioxide_in_air	mol m-3		
mole_concentration_of_nitrogen_monoxide_in_air	mol m-3		
mole_concentration_of_nitrous_acid_in_air	mol m-3		
mole_concentration_of_nitrous_oxide_in_air	mol m-3		
mole_concentration_of_nmvoc_expressed_as_carbon_in_air	mol m-3		
mole_concentration_of_nox_expressed_as_nitrogen_in_air	mol m-3		
mole_concentration_of_noy_expressed_as_nitrogen_in_air	mol m-3		
mole_concentration_of_organic_detritus_expressed_as_carbon_in_sea_water	mol m-3		
mole_concentration_of_organic_detritus_expressed_as_nitrogen_in_sea_water
alias: mole_concentration_of_organic_detritus_in_sea_water_expressed_as_nitrogen
mol m-3		
mole_concentration_of_organic_detritus_expressed_as_silicon_in_sea_water
alias: mole_concentration_of_organic_detritus_in_sea_water_expressed_as_silicon
mol m-3		
mole_concentration_of_ozone_in_air	mol m-3		
mole_concentration_of_particulate_matter_expressed_as_silicon_in_sea_water	mol m-3		
mole_concentration_of_particulate_organic_matter_expressed_as_iron_in_sea_water	mol m-3		
mole_concentration_of_particulate_organic_matter_expressed_as_nitrogen_in_sea_water	mol m-3		
mole_concentration_of_particulate_organic_matter_expressed_as_phosphorus_in_sea_water	mol m-3		
mole_concentration_of_peroxyacetyl_nitrate_in_air	mol m-3		
mole_concentration_of_peroxynitric_acid_in_air	mol m-3		
mole_concentration_of_phosphate_in_sea_water	mol m-3		
mole_concentration_of_phytoplankton_expressed_as_carbon_in_sea_water	mol m-3		
mole_concentration_of_phytoplankton_expressed_as_iron_in_sea_water	mol m-3		
mole_concentration_of_phytoplankton_expressed_as_nitrogen_in_sea_water
alias: mole_concentration_of_phytoplankton_in_sea_water_expressed_as_nitrogen
mol m-3		
mole_concentration_of_phytoplankton_expressed_as_phosphorus_in_sea_water	mol m-3		
mole_concentration_of_phytoplankton_expressed_as_silicon_in_sea_water	mol m-3		
mole_concentration_of_picophytoplankton_expressed_as_carbon_in_sea_water	mol m-3		
mole_concentration_of_propane_in_air	mol m-3		
mole_concentration_of_propene_in_air	mol m-3		
mole_concentration_of_radon_in_air	mol m-3		
mole_concentration_of_silicate_in_sea_water	mol m-3		
mole_concentration_of_sulfur_dioxide_in_air	mol m-3		
mole_concentration_of_toluene_in_air	mol m-3		
mole_concentration_of_water_vapor_in_air	mol m-3		
mole_concentration_of_xylene_in_air	mol m-3		
mole_concentration_of_zooplankton_expressed_as_carbon_in_sea_water	mol m-3		
mole_content_of_ozone_in_atmosphere_layer	mol m-2		
mole_fraction_of_acetic_acid_in_air	1		
mole_fraction_of_aceto_nitrile_in_air	1		
mole_fraction_of_aldehydes_in_air	1		
mole_fraction_of_alkanes_in_air	1		
mole_fraction_of_alpha_hexachlorocyclohexane_in_air	1		
mole_fraction_of_alpha_pinene_in_air	1		
mole_fraction_of_ammonia_in_air	1		
mole_fraction_of_anthropogenic_nmvoc_expressed_as_carbon_in_air	1		
mole_fraction_of_atomic_bromine_in_air	1		
mole_fraction_of_atomic_chlorine_in_air	1		
mole_fraction_of_atomic_nitrogen_in_air	1		
mole_fraction_of_benzene_in_air	1		
mole_fraction_of_beta_pinene_in_air	1		
mole_fraction_of_biogenic_nmvoc_expressed_as_carbon_in_air	1		
mole_fraction_of_bromine_chloride_in_air	1		
mole_fraction_of_bromine_monoxide_in_air	1		
mole_fraction_of_bromine_nitrate_in_air	1		
mole_fraction_of_brox_expressed_as_bromine_in_air	1		
mole_fraction_of_butane_in_air	1		
mole_fraction_of_carbon_dioxide_in_air	1		
mole_fraction_of_carbon_monoxide_in_air	1		
mole_fraction_of_carbon_tetrachloride_in_air	1		
mole_fraction_of_cfc113a_in_air	1		
mole_fraction_of_cfc113_in_air	1		
mole_fraction_of_cfc114_in_air	1		
mole_fraction_of_cfc115_in_air	1		
mole_fraction_of_cfc11_in_air	1		
mole_fraction_of_cfc12_in_air	1		
mole_fraction_of_chlorine_dioxide_in_air
alias: mole_fraction_of_chlorine dioxide_in_air
1		
mole_fraction_of_chlorine_monoxide_in_air
alias: mole_fraction_of_chlorine monoxide_in_air
1		
mole_fraction_of_chlorine_nitrate_in_air	1		
mole_fraction_of_clox_expressed_as_chlorine_in_air	1		
mole_fraction_of_dichlorine_in_air	1		
mole_fraction_of_dichlorine_peroxide_in_air
alias: mole_fraction_of_dichlorine peroxide_in_air
1		
mole_fraction_of_dimethyl_sulfide_in_air	1		
mole_fraction_of_dinitrogen_pentoxide_in_air	1		
mole_fraction_of_ethane_in_air	1		
mole_fraction_of_ethanol_in_air	1		
mole_fraction_of_ethene_in_air	1		
mole_fraction_of_ethyne_in_air	1		
mole_fraction_of_formaldehyde_in_air	1		
mole_fraction_of_formic_acid_in_air	1		
mole_fraction_of_gaseous_divalent_mercury_in_air	1		
mole_fraction_of_gaseous_elemental_mercury_in_air	1		
mole_fraction_of_halon1202_in_air	1		
mole_fraction_of_halon1211_in_air	1		
mole_fraction_of_halon1301_in_air	1		
mole_fraction_of_halon2402_in_air	1		
mole_fraction_of_hcc140a_in_air	1		
mole_fraction_of_hcfc141b_in_air	1		
mole_fraction_of_hcfc142b_in_air	1		
mole_fraction_of_hcfc22_in_air	1		
mole_fraction_of_hexachlorobiphenyl_in_air	1		
mole_fraction_of_hox_expressed_as_hydrogen_in_air	1		
mole_fraction_of_hydrogen_bromide_in_air	1		
mole_fraction_of_hydrogen_chloride_in_air	1		
mole_fraction_of_hydrogen_cyanide_in_air	1		
mole_fraction_of_hydrogen_peroxide_in_air	1		
mole_fraction_of_hydrogen_sulfide_in_air	1		
mole_fraction_of_hydroperoxyl_radical_in_air	1		
mole_fraction_of_hydroxyl_radical_in_air	1		
mole_fraction_of_hypobromous_acid_in_air	1		
mole_fraction_of_hypochlorous_acid_in_air
alias: mole_fraction_of_hypochlorous acid_in_air
1		
mole_fraction_of_inorganic_bromine_in_air
alias: mole_fraction_of_total_inorganic_bromine_in_air
1		
mole_fraction_of_inorganic_chlorine_in_air	1		
mole_fraction_of_isoprene_in_air	1		
mole_fraction_of_limonene_in_air	1		
mole_fraction_of_methane_in_air	1		
mole_fraction_of_methanol_in_air	1		
mole_fraction_of_methlyglyoxal_in_air	1		
mole_fraction_of_methyl_bromide_in_air	1		
mole_fraction_of_methyl_chloride_in_air	1		
mole_fraction_of_methyl_hydroperoxide_in_air	1		
mole_fraction_of_methyl_peroxy_radical_in_air	1		
mole_fraction_of_molecular_hydrogen_in_air	1		
mole_fraction_of_nitrate_radical_in_air	1		
mole_fraction_of_nitric_acid_in_air	1		
mole_fraction_of_nitric_acid_trihydrate_ambient_aerosol_in_air	1		
mole_fraction_of_nitrogen_dioxide_in_air	1		
mole_fraction_of_nitrogen_monoxide_in_air	1		
mole_fraction_of_nitrous_acid_in_air	1		
mole_fraction_of_nitrous_oxide_in_air	1		
mole_fraction_of_nmvoc_expressed_as_carbon_in_air	1		
mole_fraction_of_nox_expressed_as_nitrogen_in_air	1		
mole_fraction_of_noy_expressed_as_nitrogen_in_air
alias: mole_fraction_of_total_reactive_nitrogen_in_air
1		
mole_fraction_of_ozone_in_air
alias: mole_fraction_of_o3_in_air
1	tro3	
mole_fraction_of_peroxyacetyl_nitrate_in_air	1		
mole_fraction_of_peroxynitric_acid_in_air	1		
mole_fraction_of_propane_in_air	1		
mole_fraction_of_propene_in_air	1		
mole_fraction_of_radon_in_air	1		
mole_fraction_of_sulfur_dioxide_in_air	1		
mole_fraction_of_toluene_in_air	1		
mole_fraction_of_water_vapor_in_air	1		
mole_fraction_of_xylene_in_air	1		
mole_ratio_of_nitrate_to_phosphate_in_sea_water	1		
moles_of_cfc11_per_unit_mass_in_sea_water
alias: moles_per_unit_mass_of_cfc11_in_sea_water
mol kg-1		
moles_of_nitrate_and_nitrite_per_unit_mass_in_sea_water	mol kg-1		
moles_of_nitrate_per_unit_mass_in_sea_water	mol kg-1		
moles_of_nitrite_per_unit_mass_in_sea_water	mol kg-1		
moles_of_oxygen_per_unit_mass_in_sea_water	mol kg-1		
moles_of_phosphate_per_unit_mass_in_sea_water	mol kg-1		
moles_of_silicate_per_unit_mass_in_sea_water	mol kg-1		
net_downward_longwave_flux_in_air	W m-2		
net_downward_longwave_flux_in_air_assuming_clear_sky	W m-2		
net_downward_radiative_flux_at_top_of_atmosphere_model	W m-2	rtmt	
net_downward_shortwave_flux_at_sea_water_surface	W m-2		
net_downward_shortwave_flux_in_air	W m-2		
net_downward_shortwave_flux_in_air_assuming_clear_sky	W m-2	rsntpcs	
net_primary_mole_productivity_of_biomass_expressed_as_carbon_by_calcareous_phytoplankton
alias: net_primary_mole_productivity_of_carbon_by_calcareous_phytoplankton
mol m-2 s-1		
net_primary_mole_productivity_of_biomass_expressed_as_carbon_by_diatoms
alias: net_primary_mole_productivity_of_carbon_by_diatoms
mol m-2 s-1		
net_primary_mole_productivity_of_biomass_expressed_as_carbon_by_diazotrophs
alias: net_primary_mole_productivity_of_carbon_by_diazotrophs
mol m-2 s-1		
net_primary_mole_productivity_of_biomass_expressed_as_carbon_by_miscellaneous_phytoplankton
alias: net_primary_mole_productivity_of_carbon_by_miscellaneous_phytoplankton
mol m-2 s-1		
net_primary_mole_productivity_of_biomass_expressed_as_carbon_by_phytoplankton
alias: net_primary_mole_productivity_of_carbon_by_phytoplankton
mol m-2 s-1		
net_primary_mole_productivity_of_biomass_expressed_as_carbon_by_picophytoplankton
alias: net_primary_mole_productivity_of_carbon_by_picophytoplankton
mol m-2 s-1		
net_primary_mole_productivity_of_biomass_expressed_as_carbon_due_to_nitrate_utilization
alias: net_primary_mole_productivity_of_carbon_due_to_nitrate_utilization
mol m-2 s-1		
net_primary_production_of_biomass_expressed_as_carbon_per_unit_volume_in_sea_water	kg m-3 s-1		
net_primary_productivity_of_biomass_expressed_as_carbon
alias: net_primary_productivity_of_carbon
kg m-2 s-1		
net_primary_productivity_of_biomass_expressed_as_carbon_accumulated_in_leaves
alias: net_primary_productivity_of_carbon_accumulated_in_leaves
kg m-2 s-1		
net_primary_productivity_of_biomass_expressed_as_carbon_accumulated_in_roots
alias: net_primary_productivity_of_carbon_accumulated_in_roots
kg m-2 s-1		
net_primary_productivity_of_biomass_expressed_as_carbon_accumulated_in_wood
alias: net_primary_productivity_of_carbon_accumulated_in_wood
kg m-2 s-1		
net_rate_of_absorption_of_longwave_energy_in_atmosphere_layer	W m-2		
net_rate_of_absorption_of_shortwave_energy_in_atmosphere_layer	W m-2		
net_upward_longwave_flux_in_air	W m-2		115
net_upward_longwave_flux_in_air_assuming_clear_sky	W m-2	rlntpcs	
net_upward_shortwave_flux_in_air	W m-2		116
net_upward_shortwave_flux_in_air_assuming_clear_sky	W m-2		
normalized_difference_vegetation_index	1		
northward_atmosphere_dry_static_energy_transport_across_unit_distance	W m-1		
northward_atmosphere_heat_transport	W		
northward_atmosphere_water_transport_across_unit_distance	kg s-1 m-1		
northward_atmosphere_water_vapor_transport_across_unit_distance	kg m-1 s-1		
northward_derivative_of_eastward_sea_ice_velocity	s-1		
northward_eliassen_palm_flux_in_air
alias: northward_eliassen_palm_flux
m3 s-2		
northward_heat_flux_in_air_due_to_eddy_advection
alias: northward_heat_flux_due_to_eddy_advection
W m-2		
northward_mass_flux_of_air	kg m-2 s-1		
northward_momentum_flux_correction	Pa	tauvcorr	
northward_ocean_freshwater_transport	kg s-1		
northward_ocean_freshwater_transport_due_to_bolus_advection	kg s-1		
northward_ocean_freshwater_transport_due_to_diffusion	kg s-1		
northward_ocean_freshwater_transport_due_to_gyre	kg s-1		
northward_ocean_freshwater_transport_due_to_overturning	kg s-1		
northward_ocean_heat_transport	W		
northward_ocean_heat_transport_due_to_bolus_advection	W		
northward_ocean_heat_transport_due_to_diffusion	W	htovdiff	
northward_ocean_heat_transport_due_to_gyre	W	htovgyre	
northward_ocean_heat_transport_due_to_overturning	W	htovovrt	
northward_ocean_salt_transport	kg s-1		
northward_ocean_salt_transport_due_to_bolus_advection	kg s-1		
northward_ocean_salt_transport_due_to_diffusion	kg s-1	sltovdiff	
northward_ocean_salt_transport_due_to_gyre	kg s-1	sltovgyre	
northward_ocean_salt_transport_due_to_overturning	kg s-1	sltovovrt	
northward_sea_ice_displacement	m		
northward_sea_ice_velocity	m s-1		96
northward_sea_water_velocity	m s-1		50
northward_sea_water_velocity_assuming_no_tide	m s-1		
northward_transformed_eulerian_mean_air_velocity
alias: northward_transformed_eulerian_mean_velocity
m s-1		
northward_water_vapor_flux_in_air
alias: northward_water_vapor_flux
kg m-2 s-1		
northward_water_vapor_transport_across_unit_distance_in_atmosphere_layer	kg m-1 s-1		
northward_wind	m s-1	va	34 E132
northward_wind_shear	s-1		46
number_concentration_of_ambient_aerosol_in_air	m-3		
number_concentration_of_cloud_liquid_water_particles_in_air	m-3		
number_concentration_of_cloud_liquid_water_particles_in_air_at_liquid_water_cloud_top	m-3		
number_concentration_of_coarse_mode_ambient_aerosol_in_air	m-3		
number_concentration_of_ice_crystals_in_air	m-3		
number_concentration_of_ice_crystals_in_air_at_ice_cloud_top	m-3		
number_concentration_of_nucleation_mode_ambient_aerosol_in_air	m-3		
number_of_days_with_air_temperature_above_threshold	1		
number_of_days_with_air_temperature_below_threshold	1		
number_of_days_with_lwe_thickness_of_precipitation_amount_above_threshold	1		
number_of_days_with_wind_speed_above_threshold	1		
number_of_icebergs_per_unit_area	m-2		
ocean_barotropic_mass_streamfunction	kg s-1		
ocean_barotropic_streamfunction	m3 s-1	stfbaro	
ocean_heat_x_transport	W		
ocean_heat_x_transport_due_to_bolus_advection	W		
ocean_heat_x_transport_due_to_diffusion	W		
ocean_heat_y_transport	W		
ocean_heat_y_transport_due_to_bolus_advection	W		
ocean_heat_y_transport_due_to_diffusion	W		
ocean_integral_of_sea_water_temperature_wrt_depth	K m		
ocean_isopycnal_layer_thickness_diffusivity	m2 s-1		
ocean_kinetic_energy_dissipation_per_unit_area_due_to_vertical_friction	W m-2		
ocean_kinetic_energy_dissipation_per_unit_area_due_to_xy_friction	W m-2		
ocean_mass_content_of_dissolved_inorganic_carbon	kg m-2		
ocean_mass_x_transport	kg s-1		
ocean_mass_x_transport_due_to_advection	kg s-1		
ocean_mass_x_transport_due_to_advection_and_bolus_advection	kg s-1		
ocean_mass_y_transport	kg s-1		
ocean_mass_y_transport_due_to_advection	kg s-1		
ocean_mass_y_transport_due_to_advection_and_bolus_advection	kg s-1		
ocean_meridional_overturning_mass_streamfunction	kg s-1		
ocean_meridional_overturning_mass_streamfunction_due_to_bolus_advection	kg s-1		
ocean_meridional_overturning_streamfunction	m3 s-1	stfmmcgo	
ocean_mixed_layer_thickness	m		67
ocean_mixed_layer_thickness_defined_by_mixing_scheme	m		
ocean_mixed_layer_thickness_defined_by_sigma_t	m		
ocean_mixed_layer_thickness_defined_by_sigma_theta	m		
ocean_mixed_layer_thickness_defined_by_temperature	m		
ocean_mixed_layer_thickness_defined_by_vertical_tracer_diffusivity	m		
ocean_momentum_xy_biharmonic_diffusivity	m4 s-1		
ocean_momentum_xy_laplacian_diffusivity	m2 s-1		
ocean_montgomery_potential	m2 s-2		
ocean_rigid_lid_pressure	Pa		
ocean_rigid_lid_pressure_expressed_as_sea_surface_height_above_geoid	m		
ocean_salt_x_transport	1e-3 kg s-1		
ocean_salt_y_transport	1e-3 kg s-1		
ocean_s_coordinate	1		
ocean_s_coordinate_g1	1		
ocean_s_coordinate_g2	1		
ocean_sigma_coordinate	1		
ocean_tracer_bolus_biharmonic_diffusivity	m4 s-1		
ocean_tracer_bolus_laplacian_diffusivity	m2 s-1		
ocean_tracer_epineutral_biharmonic_diffusivity	m4 s-1		
ocean_tracer_epineutral_laplacian_diffusivity	m2 s-1		
ocean_tracer_xy_biharmonic_diffusivity	m4 s-1		
ocean_tracer_xy_laplacian_diffusivity	m2 s-1		
ocean_vertical_diffusivity	m2 s-1		
ocean_vertical_heat_diffusivity	m2 s-1		
ocean_vertical_momentum_diffusivity	m2 s-1		
ocean_vertical_momentum_diffusivity_due_to_background	m2 s-1		
ocean_vertical_momentum_diffusivity_due_to_convection	m2 s-1		
ocean_vertical_momentum_diffusivity_due_to_form_drag	m2 s-1		
ocean_vertical_momentum_diffusivity_due_to_tides	m2 s-1		
ocean_vertical_salt_diffusivity	m2 s-1		
ocean_vertical_tracer_diffusivity	m2 s-1		
ocean_vertical_tracer_diffusivity_due_to_background	m2 s-1		
ocean_vertical_tracer_diffusivity_due_to_convection	m2 s-1		
ocean_vertical_tracer_diffusivity_due_to_tides	m2 s-1		
ocean_vertical_tracer_diffusivity_due_to_wind_mixing	m2 s-1		
ocean_volume	m3		
ocean_volume_fraction	1		
ocean_volume_transport_across_line	m3 s-1		
ocean_volume_x_transport	m3 s-1		
ocean_volume_y_transport	m3 s-1		
ocean_y_overturning_mass_streamfunction	kg s-1		
ocean_y_overturning_mass_streamfunction_due_to_bolus_advection	kg s-1		
omnidirectional_photosynthetic_spherical_irradiance_in_sea_water	W m-2		
omnidirectional_spherical_irradiance_per_unit_wavelength_in_sea_water
alias: omnidirectional_spectral_spherical_irradiance_in_sea_water
W m-3		
optical_thickness_of_atmosphere_layer_due_to_ambient_aerosol
alias: optical_thickness_of_atmosphere_layer_due_to_aerosol
1		
original_air_pressure_of_lifted_parcel	Pa		
permafrost_layer_thickness	m		
phase_of_global_average_sea_level_change	degree		
planetary_albedo	1		
plant_respiration_carbon_flux	kg m-2 s-1		
platform_azimuth_angle	degree		
platform_course	degree		
platform_id
alias: station_wmo_id
platform_name
alias: station_description
platform_orientation	degree		
platform_pitch_angle	degree		
platform_pitch_rate	degree s-1		
platform_roll_angle	degree		
platform_roll_rate	degree s-1		
platform_speed_wrt_air	m s-1		
platform_speed_wrt_ground	m s-1		
platform_speed_wrt_sea_water	m s-1		
platform_view_angle	degree		
platform_yaw_angle	degree		
platform_yaw_rate	degree s-1		
platform_zenith_angle	degree		
potential_energy_content_of_atmosphere_layer	J m-2		
potential_vorticity_of_atmosphere_layer	Pa-1 s-1		
potential_vorticity_of_ocean_layer	m-1 s-1		
precipitation_amount	kg m-2		61
precipitation_flux	kg m-2 s-1	pr	59
precipitation_flux_onto_canopy
alias: precipitation_flux_onto_canopy_where_land
kg m-2 s-1	prveg	
product_of_air_temperature_and_omega	K Pa s-1		
product_of_air_temperature_and_specific_humidity	K		
product_of_eastward_sea_water_velocity_and_salinity	m s-1		
product_of_eastward_sea_water_velocity_and_temperature	K m s-1		
product_of_eastward_wind_and_air_temperature	K m s-1		
product_of_eastward_wind_and_geopotential_height	m2 s-1	mpuzga	
product_of_eastward_wind_and_northward_wind	m2 s-2	mpuva	
product_of_eastward_wind_and_omega	Pa m s-2		
product_of_eastward_wind_and_specific_humidity	m s-1		
product_of_eastward_wind_and_upward_air_velocity	m2 s-2		
product_of_geopotential_height_and_omega	Pa m s-1		
product_of_northward_sea_water_velocity_and_salinity	m s-1		
product_of_northward_sea_water_velocity_and_temperature	K m s-1		
product_of_northward_wind_and_air_temperature	K m s-1	mpvta	
product_of_northward_wind_and_geopotential_height	m2 s-1	mpvzga	
product_of_northward_wind_and_omega	Pa m s-2		
product_of_northward_wind_and_specific_humidity
alias: product_of_northward_wind_and_specific_humdity
m s-1	mpvhusa	
product_of_northward_wind_and_upward_air_velocity	m2 s-2		
product_of_omega_and_air_temperature	K Pa s-1	mpwapta	
product_of_omega_and_specific_humidity	Pa s-1	mpwhusa	
product_of_specific_humidity_and_omega	Pa s-1		
product_of_upward_air_velocity_and_air_temperature	K m s-1		
product_of_upward_air_velocity_and_specific_humidity	m s-1		
projection_x_coordinate	m		
projection_y_coordinate	m		
pseudo_equivalent_potential_temperature	K		14
pseudo_equivalent_temperature	K		
radial_sea_water_velocity_away_from_instrument	m s-1		
radial_velocity_of_scatterers_away_from_instrument	m s-1		
radiation_frequency	s-1		
radiation_wavelength
alias: electromagnetic_wavelength
m		
rainfall_amount	kg m-2		
rainfall_flux	kg m-2 s-1		
rainfall_rate	m s-1		
ratio_of_x_derivative_of_ocean_rigid_lid_pressure_to_sea_surface_density	m s-2		
ratio_of_y_derivative_of_ocean_rigid_lid_pressure_to_sea_surface_density	m s-2		
realization	1		
reference_sea_water_density_for_boussinesq_approximation	kg m-3		
region	string		
relative_humidity	1	hur	52 E157
relative_platform_azimuth_angle	degree		
relative_sensor_azimuth_angle	degree		
richardson_number_in_sea_water	1		
root_carbon_content	kg m-2		
root_depth	m		
runoff_amount	kg m-2		
runoff_amount_excluding_baseflow	kg m-2		
runoff_flux	kg m-2 s-1	mrro	
salt_flux_into_sea_water_from_rivers	kg m-2 s-1		
scattering_angle	rad		
sea_area	m2		
sea_area_fraction	1		
sea_floor_depth_below_geoid
alias: sea_floor_depth
m	zobt	
sea_floor_depth_below_sea_level	m		
sea_floor_depth_below_sea_surface	m		
sea_ice_albedo	1		
sea_ice_amount	kg m-2		
sea_ice_and_surface_snow_amount	kg m-2		
sea_ice_area	m2		
sea_ice_area_fraction	1	sic	91
sea_ice_classification	1		
sea_ice_draft	m		
sea_ice_extent	m2		
sea_ice_freeboard	m		
sea_ice_mass	kg		
sea_ice_salinity	1e-3		
sea_ice_speed	m s-1		94
sea_ice_surface_temperature	K		
sea_ice_temperature	K		
sea_ice_thickness	m	sit	92
sea_ice_transport_across_line	kg s-1		
sea_ice_volume	m3		
sea_ice_x_displacement	m		
sea_ice_x_transport	kg s-1		
sea_ice_x_velocity	m s-1		
sea_ice_y_displacement	m		
sea_ice_y_transport	kg s-1		
sea_ice_y_velocity	m s-1		
sea_surface_density	kg m-3		
sea_surface_foundation_temperature	K		
sea_surface_height_above_geoid
alias: sea_surface_elevation
alias: sea_surface_elevation_anomaly
m		
sea_surface_height_above_reference_ellipsoid	m		
sea_surface_height_above_sea_level
alias: sea_surface_height
m		82
sea_surface_height_amplitude_due_to_earth_tide	m		
sea_surface_height_amplitude_due_to_equilibrium_ocean_tide	m		
sea_surface_height_amplitude_due_to_geocentric_ocean_tide	m		
sea_surface_height_amplitude_due_to_non_equilibrium_ocean_tide	m		
sea_surface_height_amplitude_due_to_pole_tide	m		
sea_surface_height_bias_due_to_sea_surface_roughness	m		
sea_surface_height_correction_due_to_air_pressure_and_wind_at_high_frequency	m		
sea_surface_height_correction_due_to_air_pressure_at_low_frequency	m		
sea_surface_salinity	1e-3		
sea_surface_skin_temperature	K		
sea_surface_subskin_temperature	K		
sea_surface_swell_wave_mean_period_from_variance_spectral_density_first_frequency_moment	s		
sea_surface_swell_wave_mean_period_from_variance_spectral_density_inverse_frequency_moment	s		
sea_surface_swell_wave_mean_period_from_variance_spectral_density_second_frequency_moment	s		
sea_surface_swell_wave_period
alias: swell_wave_period
s		106
sea_surface_swell_wave_significant_height
alias: significant_height_of_swell_waves
m		105
sea_surface_swell_wave_to_direction
alias: direction_of_swell_wave_velocity
degree		104
sea_surface_swell_wave_zero_upcrossing_period	s		
sea_surface_temperature	K		
sea_surface_wave_directional_variance_spectral_density	m2 s rad-1		
sea_surface_wave_from_direction	degree		
sea_surface_wave_mean_period_from_variance_spectral_density_first_frequency_moment	s		
sea_surface_wave_mean_period_from_variance_spectral_density_inverse_frequency_moment	s		
sea_surface_wave_mean_period_from_variance_spectral_density_second_frequency_moment	s		
sea_surface_wave_period_at_variance_spectral_density_maximum	s		
sea_surface_wave_significant_height
alias: significant_height_of_wind_and_swell_waves
m		100
sea_surface_wave_to_direction	degree		
sea_surface_wave_variance_spectral_density	m2 s		
sea_surface_wave_zero_upcrossing_period	s		
sea_surface_wind_wave_mean_period_from_variance_spectral_density_first_frequency_moment	s		
sea_surface_wind_wave_mean_period_from_variance_spectral_density_inverse_frequency_moment	s		
sea_surface_wind_wave_mean_period_from_variance_spectral_density_second_frequency_moment	s		
sea_surface_wind_wave_period
alias: wind_wave_period
s		103
sea_surface_wind_wave_significant_height
alias: significant_height_of_wind_waves
m		102
sea_surface_wind_wave_to_direction
alias: direction_of_wind_wave_velocity
degree		101
sea_surface_wind_wave_zero_upcrossing_period	s		
sea_water_absolute_salinity	g kg-1		
sea_water_age_since_surface_contact	year		
sea_water_alkalinity_expressed_as_mole_equivalent	mol m-3		
sea_water_conservative_temperature	K		
sea_water_cox_salinity	1e-3		
sea_water_density	kg m-3		
sea_water_electrical_conductivity	S m-1		
sea_water_knudsen_salinity	1e-3		
sea_water_mass	kg		
sea_water_mass_per_unit_area	kg m-2		
sea_water_neutral_density	kg m-3		
sea_water_ph_reported_on_total_scale	1		
sea_water_potential_density	kg m-3		
sea_water_potential_temperature	K		
sea_water_practical_salinity	1e-3		
sea_water_preformed_salinity	g kg-1		
sea_water_pressure	dbar		
sea_water_pressure_at_sea_floor	dbar		
sea_water_pressure_at_sea_water_surface	dbar		
sea_water_pressure_due_to_sea_water	dbar		
sea_water_reference_salinity	g kg-1		
sea_water_salinity	1e-3	so	88
sea_water_sigma_t	kg m-3		
sea_water_sigma_theta	kg m-3		
sea_water_specific_potential_enthalpy	J kg-1		
sea_water_speed	m s-1		48
sea_water_temperature	K	to	80
sea_water_transport_across_line	kg s-1		
sea_water_turbidity	1		
sea_water_volume	m3		
sea_water_x_velocity
alias: x_sea_water_velocity
m s-1		
sea_water_y_velocity
alias: y_sea_water_velocity
m s-1		
secchi_depth_of_sea_water	m		
sensor_azimuth_angle	degree		
sensor_band_central_radiation_frequency	s-1		
sensor_band_central_radiation_wavelength	m		
sensor_band_central_radiation_wavenumber	m-1		
sensor_band_identifier			
sensor_view_angle	degree		
sensor_zenith_angle	degree		
shallow_convection_time_fraction	1		
sinking_mole_flux_of_aragonite_expressed_as_carbon_in_sea_water	mol m-2 s-1		
sinking_mole_flux_of_calcite_expressed_as_carbon_in_sea_water	mol m-2 s-1		
sinking_mole_flux_of_particulate_iron_in_sea_water	mol m-2 s-1		
sinking_mole_flux_of_particulate_organic_matter_expressed_as_carbon_in_sea_water	mol m-2 s-1		
sinking_mole_flux_of_particulate_organic_nitrogen_in_sea_water	mol m-2 s-1		
sinking_mole_flux_of_particulate_organic_phosphorus_in_sea_water	mol m-2 s-1		
sinking_mole_flux_of_particulate_silicon_in_sea_water	mol m-2 s-1		
slow_soil_pool_carbon_content	kg m-2		
snow_density	kg m-3		
snowfall_amount	kg m-2		
snowfall_flux	kg m-2 s-1	prsn	64
snow_grain_size	m		
soil_albedo	1		
soil_carbon_content	kg m-2		
soil_frozen_water_content	kg m-2	mrfso	
soil_hydraulic_conductivity_at_saturation	m s-1		
soil_moisture_content	kg m-2	mrso	86
soil_moisture_content_at_field_capacity	kg m-2	mrsofc	
soil_porosity	1		
soil_respiration_carbon_flux	kg m-2 s-1		
soil_suction_at_saturation	Pa		
soil_temperature	K		85
soil_thermal_capacity	J kg-1 K-1		
soil_thermal_conductivity	W m-1 K-1		
soil_type	1		
solar_azimuth_angle	degree		
solar_elevation_angle	degree		
solar_zenith_angle	degree		
soot_content_of_surface_snow
alias: snow_soot_content
kg m-2		
sound_frequency	s-1		
sound_intensity_in_air	W m-2		
sound_intensity_in_water	W m-2		
sound_intensity_level_in_air	dB		
sound_intensity_level_in_water	dB		
sound_pressure_in_air	Pa		
sound_pressure_in_water	Pa		
sound_pressure_level_in_air	dB		
sound_pressure_level_in_water	dB		
specific_dry_energy_of_air	m2 s-2		
specific_gravitational_potential_energy
alias: specific_potential_energy
J kg-1		
specific_humidity	1	hus	51 E133
specific_kinetic_energy_of_air	m2 s-2		
specific_kinetic_energy_of_sea_water	m2 s-2		
speed_of_sound_in_air	m s-1		
speed_of_sound_in_sea_water	m s-1		
spell_length_of_days_with_air_temperature_above_threshold	day		
spell_length_of_days_with_air_temperature_below_threshold	day		
spell_length_of_days_with_lwe_thickness_of_precipitation_amount_above_threshold	day		
spell_length_of_days_with_lwe_thickness_of_precipitation_amount_below_threshold	day		
square_of_air_temperature	K2	mptta	
square_of_brunt_vaisala_frequency_in_air	s-2		N138
square_of_eastward_wind	m2 s-2	mpuua	
square_of_geopotential_height	m2		
square_of_lagrangian_tendency_of_air_pressure	Pa2 s-2		
square_of_northward_wind	m2 s-2	mpvva	
square_of_ocean_mixed_layer_thickness_defined_by_sigma_t	m2		
square_of_sea_surface_height_above_geoid	m2		
square_of_sea_surface_temperature	K2		
square_of_upward_air_velocity	m2 s-2		
square_of_upward_ocean_mass_transport	kg2 s-2		
stratiform_cloud_area_fraction
alias: large_scale_cloud_area_fraction
1		
stratiform_cloud_area_fraction_in_atmosphere_layer	1		
stratiform_cloud_longwave_emissivity	1		
stratiform_graupel_flux
alias: large_scale_graupel_flux
kg m-2 s-1		
stratiform_precipitation_amount
alias: large_scale_precipitation_amount
kg m-2		62
stratiform_precipitation_flux
alias: large_scale_precipitation_flux
kg m-2 s-1		
stratiform_rainfall_amount
alias: large_scale_rainfall_amount
kg m-2		
stratiform_rainfall_flux
alias: large_scale_rainfall_flux
kg m-2 s-1		
stratiform_rainfall_rate
alias: large_scale_rainfall_rate
m s-1		
stratiform_snowfall_amount
alias: large_scale_snowfall_amount
kg m-2		79
stratiform_snowfall_flux
alias: large_scale_snowfall_flux
kg m-2 s-1		
stratosphere_mole_content_of_nitrogen_dioxide	mol m-2		
subsurface_litter_carbon_content	kg m-2		
subsurface_runoff_amount	kg m-2		
subsurface_runoff_flux	kg m-2 s-1		
sunlit_binary_mask	1		
surface_air_pressure	Pa	ps	E134
surface_albedo	1		84 E174
surface_albedo_assuming_deep_snow	1		
surface_albedo_assuming_no_snow	1		
surface_altitude	m	orog	
surface_backwards_scattering_coefficient_of_radar_wave	1		
surface_bidirectional_reflectance	1		
surface_brightness_temperature	K		
surface_carbon_dioxide_partial_pressure_difference_between_air_and_sea_water	Pa		
surface_carbon_dioxide_partial_pressure_difference_between_sea_water_and_air	Pa		
surface_diffuse_downwelling_photosynthetic_radiative_flux_in_air	W m-2		
surface_diffuse_downwelling_shortwave_flux_in_air	W m-2		
surface_diffuse_downwelling_shortwave_flux_in_air_assuming_clear_sky	W m-2		
surface_downward_eastward_stress	Pa	tauu	E180
surface_downward_heat_flux_in_air	W m-2	hfns	
surface_downward_heat_flux_in_sea_water	W m-2		
surface_downward_heat_flux_in_snow	Wm-2		
surface_downward_latent_heat_flux	W m-2		
surface_downward_mass_flux_of_carbon_dioxide_expressed_as_carbon	kg m-2 s-1		
surface_downward_mole_flux_of_carbon_dioxide
alias: surface_carbon_dioxide_mole_flux
mol m-2 s-1		
surface_downward_mole_flux_of_molecular_oxygen	mol m-2 s-1		
surface_downward_northward_stress	Pa	tauv	E181
surface_downward_sensible_heat_flux	W m-2		
surface_downward_water_flux	kg m-2 s-1		
surface_downward_x_stress	Pa		
surface_downward_x_stress_correction	Pa		
surface_downward_y_stress	Pa		
surface_downward_y_stress_correction	Pa		
surface_downwelling_longwave_flux_in_air
alias: surface_downwelling_longwave_flux
W m-2	rlds	
surface_downwelling_longwave_flux_in_air_assuming_clear_sky	W m-2	rldscs	
surface_downwelling_photon_flux_in_sea_water	mol m-2 s-1		
surface_downwelling_photon_flux_per_unit_wavelength_in_sea_water
alias: surface_downwelling_spectral_photon_flux_in_sea_water
mol m-2 s-1 m-1		
surface_downwelling_photon_radiance_in_sea_water	mol m-2 s-1 sr-1		
surface_downwelling_photon_radiance_per_unit_wavelength_in_sea_water
alias: surface_downwelling_spectral_photon_radiance_in_sea_water
mol m-2 s-1 m-1 sr-1		
surface_downwelling_photon_spherical_irradiance_in_sea_water	mol m-2 s-1		
surface_downwelling_photon_spherical_irradiance_per_unit_wavelength_in_sea_water
alias: surface_downwelling_spectral_photon_spherical_irradiance_in_sea_water
mol m-2 s-1 m-1		
surface_downwelling_photosynthetic_photon_flux_in_air	mol m-2 s-1		
surface_downwelling_photosynthetic_photon_flux_in_sea_water	mol m-2 s-1		
surface_downwelling_photosynthetic_photon_radiance_in_sea_water	mol m-2 s-1 sr-1		
surface_downwelling_photosynthetic_photon_spherical_irradiance_in_sea_water	mol m-2 s-1		
surface_downwelling_photosynthetic_radiance_in_sea_water	W m-2 sr-1		
surface_downwelling_photosynthetic_radiative_flux_in_air	W m-2		
surface_downwelling_photosynthetic_radiative_flux_in_sea_water	W m-2		
surface_downwelling_photosynthetic_spherical_irradiance_in_sea_water	W m-2		
surface_downwelling_radiance_in_sea_water	W m-2 sr-1		
surface_downwelling_radiance_per_unit_wavelength_in_sea_water
alias: surface_downwelling_spectral_radiance_in_sea_water
W m-2 m-1 sr-1		
surface_downwelling_radiative_flux_in_sea_water	W m-2		
surface_downwelling_radiative_flux_per_unit_wavelength_in_air
alias: surface_downwelling_spectral_radiative_flux_in_air
W m-2 m-1		
surface_downwelling_radiative_flux_per_unit_wavelength_in_sea_water
alias: surface_downwelling_spectral_radiative_flux_in_sea_water
W m-2 m-1		
surface_downwelling_shortwave_flux_in_air
alias: surface_downwelling_shortwave_flux
W m-2	rsds	117 E169
surface_downwelling_shortwave_flux_in_air_assuming_clear_sky
alias: surface_downwelling_shortwave_flux_assuming_clear_sky
W m-2	rsdscs	
surface_downwelling_spherical_irradiance_in_sea_water	W m-2		
surface_downwelling_spherical_irradiance_per_unit_wavelength_in_sea_water
alias: surface_downwelling_spectral_spherical_irradiance_in_sea_water
W m-2 m-1		
surface_drag_coefficient_for_heat_in_air
alias: atmosphere_surface_drag_coefficient_of_heat
1		
surface_drag_coefficient_for_momentum_in_air
alias: atmosphere_surface_drag_coefficient_of_momentum
1		
surface_drag_coefficient_in_air
alias: atmosphere_surface_drag_coefficient
1		
surface_eastward_sea_water_velocity	m s-1		
surface_frozen_carbon_dioxide_amount	kg m-2		
surface_geopotential	m2 s-2		
surface_geostrophic_eastward_sea_water_velocity
alias: surface_eastward_geostrophic_sea_water_velocity
m s-1		
surface_geostrophic_eastward_sea_water_velocity_assuming_sea_level_for_geoid
alias: surface_eastward_geostrophic_sea_water_velocity_assuming_sea_level_for_geoid
m s-1		
surface_geostrophic_northward_sea_water_velocity
alias: surface_northward_geostrophic_sea_water_velocity
m s-1		
surface_geostrophic_northward_sea_water_velocity_assuming_sea_level_for_geoid
alias: surface_northward_geostrophic_sea_water_velocity_assuming_sea_level_for_geoid
m s-1		
surface_geostrophic_sea_water_x_velocity	m s-1		
surface_geostrophic_sea_water_x_velocity_assuming_sea_level_for_geoid	m s-1		
surface_geostrophic_sea_water_y_velocity	m s-1		
surface_geostrophic_sea_water_y_velocity_assuming_sea_level_for_geoid	m s-1		
surface_litter_carbon_content	kg m-2		
surface_longwave_emissivity	1		
surface_microwave_emissivity	1		
surface_molecular_oxygen_partial_pressure_difference_between_sea_water_and_air	Pa		
surface_net_downward_longwave_flux	W m-2	rls	
surface_net_downward_longwave_flux_assuming_clear_sky	W m-2		E211
surface_net_downward_mass_flux_of_carbon_dioxide_expressed_as_carbon_due_to_all_land_processes	kg m-2 s-1		
surface_net_downward_mass_flux_of_carbon_dioxide_expressed_as_carbon_due_to_all_land_processes_excluding_anthropogenic_land_use_change	kg m-2 s-1		
surface_net_downward_radiative_flux
alias: surface_net_downward_radiative_flux_where_land
W m-2		
surface_net_downward_shortwave_flux	W m-2	rss	
surface_net_downward_shortwave_flux_assuming_clear_sky	W m-2		E210
surface_net_upward_longwave_flux	W m-2		112 E176
surface_net_upward_mass_flux_of_carbon_dioxide_expressed_as_carbon_due_to_emission_from_anthropogenic_land_use_change	kg m-2 s-1		
surface_net_upward_radiative_flux	W m-2		
surface_net_upward_shortwave_flux	W m-2		111 E177
surface_northward_sea_water_velocity	m s-1		
surface_partial_pressure_of_carbon_dioxide_in_air	Pa		
surface_partial_pressure_of_carbon_dioxide_in_sea_water	Pa		
surface_ratio_of_upwelling_radiance_emerging_from_sea_water_to_downwelling_radiative_flux_in_air	sr^-1		
surface_roughness_length	m		83 E173
surface_roughness_length_for_heat_in_air	m		
surface_roughness_length_for_momentum_in_air	m		
surface_runoff_amount	kg m-2		90
surface_runoff_flux	kg m-2 s-1	mrros	
surface_snow_amount	kg m-2	snw	65
surface_snow_and_ice_melt_flux	kg m-2 s-1		
surface_snow_and_ice_melt_heat_flux	W m-2		
surface_snow_and_ice_refreezing_flux	kg m-2 s-1		
surface_snow_and_ice_sublimation_flux	kg m-2 s-1		
surface_snow_area_fraction	1	snc	
surface_snow_binary_mask	1		
surface_snow_melt_amount	kg m-2		99
surface_snow_melt_and_sublimation_heat_flux	W m-2		
surface_snow_melt_flux	kg m-2 s-1	snm	
surface_snow_melt_heat_flux	W m-2		
surface_snow_sublimation_amount	kg m-2		
surface_snow_sublimation_heat_flux	W m-2		
surface_snow_thickness
alias: surface_snow_thickness_where_sea_ice
m	snd	66
surface_specific_humidity	1		
surface_temperature
alias: surface_temperature_where_land
alias: surface_temperature_where_open_sea
alias: surface_temperature_where_snow
K	ts	E139
surface_temperature_anomaly	K		
surface_upward_carbon_mass_flux_due_to_plant_respiration_for_biomass_growth	kg m-2 s-1		
surface_upward_carbon_mass_flux_due_to_plant_respiration_for_biomass_maintenance	kg m-2 s-1		
surface_upward_heat_flux_in_air	W m-2		
surface_upward_latent_heat_flux	W m-2	hfls	121 E147
surface_upward_mass_flux_of_carbon_dioxide_expressed_as_carbon_due_to_emission_from_crop_harvesting	kg m-2 s-1		
surface_upward_mass_flux_of_carbon_dioxide_expressed_as_carbon_due_to_emission_from_fires_excluding_anthropogenic_land_use_change	kg m-2 s-1		
surface_upward_mass_flux_of_carbon_dioxide_expressed_as_carbon_due_to_emission_from_grazing	kg m-2 s-1		
surface_upward_mass_flux_of_carbon_dioxide_expressed_as_carbon_due_to_emission_from_natural_sources	kg m-2 s-1		
surface_upward_mole_flux_of_carbon_dioxide
alias: surface_carbon_dioxide_mole_flux
mol m-2 s-1		
surface_upward_mole_flux_of_dimethyl_sulfide	mol m-2 s-1		
surface_upward_sensible_heat_flux
alias: surface_upward_sensible_heat_flux_where_sea
W m-2	hfss	122 E146
surface_upward_water_flux	kg m-2 s-1		
surface_upward_water_vapor_flux_in_air	kg m-2 s-1		
surface_upwelling_longwave_flux_in_air
alias: surface_upwelling_longwave_flux
W m-2	rlus	
surface_upwelling_longwave_flux_in_air_assuming_clear_sky
alias: surface_upwelling_longwave_flux_assuming_clear_sky
W m-2		
surface_upwelling_photosynthetic_photon_flux_in_air	mol m-2 s-1		
surface_upwelling_radiance_in_air	W m-2 sr-1		
surface_upwelling_radiance_in_air_emerging_from_sea_water	W m-2 sr-1		
surface_upwelling_radiance_in_air_reflected_by_sea_water	W m-2 sr-1		
surface_upwelling_radiance_in_sea_water	W m-2 sr-1		
surface_upwelling_radiance_per_unit_wavelength_in_air
alias: surface_upwelling_spectral_radiance_in_air
W m-2 m-1 sr-1		
surface_upwelling_radiance_per_unit_wavelength_in_air_emerging_from_sea_water
alias: surface_upwelling_spectral_radiance_in_air_emerging_from_sea_water
W m-2 m-1 sr-1		
surface_upwelling_radiance_per_unit_wavelength_in_air_reflected_by_sea_water
alias: surface_upwelling_spectral_radiance_in_air_reflected_by_sea_water
W m-2 m-1 sr-1		
surface_upwelling_radiance_per_unit_wavelength_in_sea_water
alias: surface_upwelling_spectral_radiance_in_sea_water
W m-2 m-1 sr-1		
surface_upwelling_radiative_flux_per_unit_wavelength_in_air
alias: surface_upwelling_spectral_radiative_flux_in_air
W m-2 m-1		
surface_upwelling_radiative_flux_per_unit_wavelength_in_sea_water
alias: surface_upwelling_spectral_radiative_flux_in_sea_water
W m-2 m-1		
surface_upwelling_shortwave_flux_in_air
alias: surface_upwelling_shortwave_flux
W m-2	rsus	
surface_upwelling_shortwave_flux_in_air_assuming_clear_sky
alias: surface_upwelling_shortwave_flux_assuming_clear_sky
W m-2	rsuscs	
surface_water_amount	kg m-2		
temperature_difference_between_ambient_air_and_air_lifted_adiabatically	K		
temperature_difference_between_ambient_air_and_air_lifted_adiabatically_from_the_surface	K		
temperature_flux_due_to_evaporation_expressed_as_heat_flux_out_of_sea_water	W m-2		
temperature_flux_due_to_rainfall_expressed_as_heat_flux_into_sea_water	W m-2		
temperature_flux_due_to_runoff_expressed_as_heat_flux_into_sea_water	W m-2		
temperature_in_surface_snow
alias: snow_temperature
K		E238
temperature_of_sensor_for_oxygen_in_sea_water	K		
tendency_of_air_density	kg m-3 s-1		
tendency_of_air_pressure	Pa s-1		3
tendency_of_air_temperature	K s-1		
tendency_of_air_temperature_due_to_advection	K s-1		
tendency_of_air_temperature_due_to_convection	K s-1		
tendency_of_air_temperature_due_to_diabatic_processes	K s-1	tnt	
tendency_of_air_temperature_due_to_diffusion	K s-1		
tendency_of_air_temperature_due_to_dry_convection	K s-1	tntdc	
tendency_of_air_temperature_due_to_longwave_heating	K s-1	tntlw	
tendency_of_air_temperature_due_to_longwave_heating_assuming_clear_sky	K s-1		
tendency_of_air_temperature_due_to_model_physics	K s-1		
tendency_of_air_temperature_due_to_moist_convection	K s-1	tntmc	
tendency_of_air_temperature_due_to_radiative_heating			
tendency_of_air_temperature_due_to_shortwave_heating	K s-1	tntsw	
tendency_of_air_temperature_due_to_shortwave_heating_assuming_clear_sky	K s-1		
tendency_of_air_temperature_due_to_stratiform_cloud_and_precipitation_and_boundary_layer_mixing	K s-1		
tendency_of_air_temperature_due_to_stratiform_precipitation
alias: tendency_of_air_temperature_due_to_large_scale_precipitation
K s-1	tntlsp	
tendency_of_air_temperature_due_to_turbulence	K s-1		
tendency_of_atmosphere_dry_energy_content	W m-2		
tendency_of_atmosphere_enthalpy_content_due_to_advection	W m-2		
tendency_of_atmosphere_kinetic_energy_content_due_to_advection	W m-2		
tendency_of_atmosphere_mass_content_of_acetic_acid_due_to_dry_deposition	kg m-2 s-1		
tendency_of_atmosphere_mass_content_of_acetic_acid_due_to_wet_deposition	kg m-2 s-1		
tendency_of_atmosphere_mass_content_of_aceto_nitrile_due_to_dry_deposition	kg m-2 s-1		
tendency_of_atmosphere_mass_content_of_alcohols_due_to_emission_from_agricultural_production	kg m-2 s-1		
tendency_of_atmosphere_mass_content_of_alcohols_due_to_emission_from_agricultural_waste_burning	kg m-2 s-1		
tendency_of_atmosphere_mass_content_of_alcohols_due_to_emission_from_energy_production_and_distribution	kg m-2 s-1		
tendency_of_atmosphere_mass_content_of_alcohols_due_to_emission_from_forest_fires	kg m-2 s-1		
tendency_of_atmosphere_mass_content_of_alcohols_due_to_emission_from_industrial_processes_and_combustion	kg m-2 s-1		
tendency_of_atmosphere_mass_content_of_alcohols_due_to_emission_from_residential_and_commercial_combustion	kg m-2 s-1		
tendency_of_atmosphere_mass_content_of_alcohols_due_to_emission_from_savanna_and_grassland_fires	kg m-2 s-1		
tendency_of_atmosphere_mass_content_of_alcohols_due_to_emission_from_solvent_production_and_use	kg m-2 s-1		
tendency_of_atmosphere_mass_content_of_alcohols_due_to_emission_from_waste_treatment_and_disposal	kg m-2 s-1		
tendency_of_atmosphere_mass_content_of_alpha_hexachlorocyclohexane_due_to_dry_deposition	kg m-2 s-1		
tendency_of_atmosphere_mass_content_of_alpha_hexachlorocyclohexane_due_to_emission	kg m-2 s-1		
tendency_of_atmosphere_mass_content_of_alpha_hexachlorocyclohexane_due_to_re_emission	kg m-2 s-1		
tendency_of_atmosphere_mass_content_of_alpha_hexachlorocyclohexane_due_to_wet_deposition	kg m-2 s-1		
tendency_of_atmosphere_mass_content_of_alpha_pinene_due_to_emission	kg m-2 s-1		
tendency_of_atmosphere_mass_content_of_ammonia_due_to_dry_deposition	kg m-2 s-1		
tendency_of_atmosphere_mass_content_of_ammonia_due_to_emission	kg m-2 s-1		
tendency_of_atmosphere_mass_content_of_ammonia_due_to_emission_from_agricultural_production	kg m-2 s-1		
tendency_of_atmosphere_mass_content_of_ammonia_due_to_emission_from_agricultural_waste_burning	kg m-2 s-1		
tendency_of_atmosphere_mass_content_of_ammonia_due_to_emission_from_energy_production_and_distribution	kg m-2 s-1		
tendency_of_atmosphere_mass_content_of_ammonia_due_to_emission_from_forest_fires	kg m-2 s-1		
tendency_of_atmosphere_mass_content_of_ammonia_due_to_emission_from_industrial_processes_and_combustion	kg m-2 s-1		
tendency_of_atmosphere_mass_content_of_ammonia_due_to_emission_from_land_transport	kg m-2 s-1		
tendency_of_atmosphere_mass_content_of_ammonia_due_to_emission_from_residential_and_commercial_combustion	kg m-2 s-1		
tendency_of_atmosphere_mass_content_of_ammonia_due_to_emission_from_savanna_and_grassland_fires	kg m-2 s-1		
tendency_of_atmosphere_mass_content_of_ammonia_due_to_wet_deposition	kg m-2 s-1		
tendency_of_atmosphere_mass_content_of_ammonium_dry_aerosol_due_to_dry_deposition	kg m-2 s-1		
tendency_of_atmosphere_mass_content_of_ammonium_dry_aerosol_due_to_wet_deposition	kg m-2 s-1		
tendency_of_atmosphere_mass_content_of_benzene_due_to_emission	kg m-2 s-1		
tendency_of_atmosphere_mass_content_of_benzene_due_to_emission_from_agricultural_production	kg m-2 s-1		
tendency_of_atmosphere_mass_content_of_benzene_due_to_emission_from_agricultural_waste_burning	kg m-2 s-1		
tendency_of_atmosphere_mass_content_of_benzene_due_to_emission_from_energy_production_and_distribution	kg m-2 s-1		
tendency_of_atmosphere_mass_content_of_benzene_due_to_emission_from_forest_fires	kg m-2 s-1		
tendency_of_atmosphere_mass_content_of_benzene_due_to_emission_from_industrial_processes_and_combustion	kg m-2 s-1		
tendency_of_atmosphere_mass_content_of_benzene_due_to_emission_from_land_transport	kg m-2 s-1		
tendency_of_atmosphere_mass_content_of_benzene_due_to_emission_from_residential_and_commercial_combustion	kg m-2 s-1		
tendency_of_atmosphere_mass_content_of_benzene_due_to_emission_from_savanna_and_grassland_fires	kg m-2 s-1		
tendency_of_atmosphere_mass_content_of_benzene_due_to_emission_from_waste_treatment_and_disposal	kg m-2 s-1		
tendency_of_atmosphere_mass_content_of_beta_pinene_due_to_emission	kg m-2 s-1		
tendency_of_atmosphere_mass_content_of_black_carbon_dry_aerosol_due_to_dry_deposition	kg m-2 s-1		
tendency_of_atmosphere_mass_content_of_black_carbon_dry_aerosol_due_to_emission	kg m-2 s-1		
tendency_of_atmosphere_mass_content_of_black_carbon_dry_aerosol_due_to_emission_from_agricultural_waste_burning	kg m-2 s-1		
tendency_of_atmosphere_mass_content_of_black_carbon_dry_aerosol_due_to_emission_from_energy_production_and_distribution	kg m-2 s-1		
tendency_of_atmosphere_mass_content_of_black_carbon_dry_aerosol_due_to_emission_from_forest_fires	kg m-2 s-1		
tendency_of_atmosphere_mass_content_of_black_carbon_dry_aerosol_due_to_emission_from_industrial_processes_and_combustion	kg m-2 s-1		
tendency_of_atmosphere_mass_content_of_black_carbon_dry_aerosol_due_to_emission_from_land_transport	kg m-2 s-1		
tendency_of_atmosphere_mass_content_of_black_carbon_dry_aerosol_due_to_emission_from_maritime_transport	kg m-2 s-1		
tendency_of_atmosphere_mass_content_of_black_carbon_dry_aerosol_due_to_emission_from_residential_and_commercial_combustion	kg m-2 s-1		
tendency_of_atmosphere_mass_content_of_black_carbon_dry_aerosol_due_to_emission_from_savanna_and_grassland_fires	kg m-2 s-1		
tendency_of_atmosphere_mass_content_of_black_carbon_dry_aerosol_due_to_emission_from_waste_treatment_and_disposal	kg m-2 s-1		
tendency_of_atmosphere_mass_content_of_black_carbon_dry_aerosol_due_to_gravitational_settling	kg m-2 s-1		
tendency_of_atmosphere_mass_content_of_black_carbon_dry_aerosol_due_to_turbulent_deposition	kg m-2 s-1		
tendency_of_atmosphere_mass_content_of_black_carbon_dry_aerosol_due_to_wet_deposition	kg m-2 s-1		
tendency_of_atmosphere_mass_content_of_butane_due_to_emission	kg m-2 s-1		
tendency_of_atmosphere_mass_content_of_butane_due_to_emission_from_agricultural_production	kg m-2 s-1		
tendency_of_atmosphere_mass_content_of_butane_due_to_emission_from_agricultural_waste_burning	kg m-2 s-1		
tendency_of_atmosphere_mass_content_of_butane_due_to_emission_from_energy_production_and_distribution	kg m-2 s-1		
tendency_of_atmosphere_mass_content_of_butane_due_to_emission_from_forest_fires	kg m-2 s-1		
tendency_of_atmosphere_mass_content_of_butane_due_to_emission_from_industrial_processes_and_combustion	kg m-2 s-1		
tendency_of_atmosphere_mass_content_of_butane_due_to_emission_from_land_transport	kg m-2 s-1		
tendency_of_atmosphere_mass_content_of_butane_due_to_emission_from_maritime_transport	kg m-2 s-1		
tendency_of_atmosphere_mass_content_of_butane_due_to_emission_from_residential_and_commercial_combustion	kg m-2 s-1		
tendency_of_atmosphere_mass_content_of_butane_due_to_emission_from_savanna_and_grassland_fires	kg m-2 s-1		
tendency_of_atmosphere_mass_content_of_butane_due_to_emission_from_waste_treatment_and_disposal	kg m-2 s-1		
tendency_of_atmosphere_mass_content_of_carbon_dioxide_due_to_emission	kg m-2 s-1		
tendency_of_atmosphere_mass_content_of_carbon_dioxide_expressed_as_carbon_due_to_anthropogenic_emission	kg m-2 s-1		
tendency_of_atmosphere_mass_content_of_carbon_dioxide_expressed_as_carbon_due_to_emission_from_fossil_fuel_combustion	kg m-2 s-1		
tendency_of_atmosphere_mass_content_of_carbon_monoxide_due_to_dry_deposition	kg m-2 s-1		
tendency_of_atmosphere_mass_content_of_carbon_monoxide_due_to_emission	kg m-2 s-1		
tendency_of_atmosphere_mass_content_of_carbon_monoxide_due_to_emission_from_agricultural_production	kg m-2 s-1		
tendency_of_atmosphere_mass_content_of_carbon_monoxide_due_to_emission_from_agricultural_waste_burning	kg m-2 s-1		
tendency_of_atmosphere_mass_content_of_carbon_monoxide_due_to_emission_from_energy_production_and_distribution	kg m-2 s-1		
tendency_of_atmosphere_mass_content_of_carbon_monoxide_due_to_emission_from_forest_fires	kg m-2 s-1		
tendency_of_atmosphere_mass_content_of_carbon_monoxide_due_to_emission_from_industrial_processes_and_combustion	kg m-2 s-1		
tendency_of_atmosphere_mass_content_of_carbon_monoxide_due_to_emission_from_land_transport	kg m-2 s-1		
tendency_of_atmosphere_mass_content_of_carbon_monoxide_due_to_emission_from_maritime_transport	kg m-2 s-1		
tendency_of_atmosphere_mass_content_of_carbon_monoxide_due_to_emission_from_residential_and_commercial_combustion	kg m-2 s-1		
tendency_of_atmosphere_mass_content_of_carbon_monoxide_due_to_emission_from_savanna_and_grassland_fires	kg m-2 s-1		
tendency_of_atmosphere_mass_content_of_carbon_monoxide_due_to_emission_from_solvent_production_and_use	kg m-2 s-1		
tendency_of_atmosphere_mass_content_of_carbon_monoxide_due_to_emission_from_waste_treatment_and_disposal	kg m-2 s-1		
tendency_of_atmosphere_mass_content_of_carbon_tetrachloride_due_to_emission	kg m-2 s-1		
tendency_of_atmosphere_mass_content_of_cfc113a_due_to_emission	kg m-2 s-1		
tendency_of_atmosphere_mass_content_of_cfc113_due_to_emission	kg m-2 s-1		
tendency_of_atmosphere_mass_content_of_cfc114_due_to_emission	kg m-2 s-1		
tendency_of_atmosphere_mass_content_of_cfc115_due_to_emission	kg m-2 s-1		
tendency_of_atmosphere_mass_content_of_cfc11_due_to_emission	kg m-2 s-1		
tendency_of_atmosphere_mass_content_of_cfc12_due_to_emission	kg m-2 s-1		
tendency_of_atmosphere_mass_content_of_chlorinated_hydrocarbons_due_to_emission_from_forest_fires	kg m-2 s-1		
tendency_of_atmosphere_mass_content_of_chlorinated_hydrocarbons_due_to_emission_from_land_transport	kg m-2 s-1		
tendency_of_atmosphere_mass_content_of_chlorinated_hydrocarbons_due_to_emission_from_savanna_and_grassland_fires	kg m-2 s-1		
tendency_of_atmosphere_mass_content_of_chlorinated_hydrocarbons_due_to_emission_from_solvent_production_and_use	kg m-2 s-1		
tendency_of_atmosphere_mass_content_of_chlorinated_hydrocarbons_due_to_emission_from_waste_treatment_and_disposal	kg m-2 s-1		
tendency_of_atmosphere_mass_content_of_dimethyl_sulfide_due_to_dry_deposition	kg m-2 s-1		
tendency_of_atmosphere_mass_content_of_dimethyl_sulfide_due_to_emission	kg m-2 s-1		
tendency_of_atmosphere_mass_content_of_dimethyl_sulfide_due_to_emission_from_forest_fires	kg m-2 s-1		
tendency_of_atmosphere_mass_content_of_dimethyl_sulfide_due_to_emission_from_savanna_and_grassland_fires	kg m-2 s-1		
tendency_of_atmosphere_mass_content_of_dimethyl_sulfide_due_to_wet_deposition	kg m-2 s-1		
tendency_of_atmosphere_mass_content_of_dust_dry_aerosol_due_to_dry_deposition	kg m-2 s-1		
tendency_of_atmosphere_mass_content_of_dust_dry_aerosol_due_to_emission	kg m-2 s-1		
tendency_of_atmosphere_mass_content_of_dust_dry_aerosol_due_to_gravitational_settling	kg m-2 s-1		
tendency_of_atmosphere_mass_content_of_dust_dry_aerosol_due_to_turbulent_deposition	kg m-2 s-1		
tendency_of_atmosphere_mass_content_of_dust_dry_aerosol_due_to_wet_deposition	kg m-2 s-1		
tendency_of_atmosphere_mass_content_of_esters_due_to_emission_from_land_transport	kg m-2 s-1		
tendency_of_atmosphere_mass_content_of_esters_due_to_emission_from_solvent_production_and_use	kg m-2 s-1		
tendency_of_atmosphere_mass_content_of_esters_due_to_emission_from_waste_treatment_and_disposal	kg m-2 s-1		
tendency_of_atmosphere_mass_content_of_ethane_due_to_emission	kg m-2 s-1		
tendency_of_atmosphere_mass_content_of_ethane_due_to_emission_from_agricultural_production	kg m-2 s-1		
tendency_of_atmosphere_mass_content_of_ethane_due_to_emission_from_agricultural_waste_burning	kg m-2 s-1		
tendency_of_atmosphere_mass_content_of_ethane_due_to_emission_from_energy_production_and_distribution	kg m-2 s-1		
tendency_of_atmosphere_mass_content_of_ethane_due_to_emission_from_forest_fires	kg m-2 s-1		
tendency_of_atmosphere_mass_content_of_ethane_due_to_emission_from_industrial_processes_and_combustion	kg m-2 s-1		
tendency_of_atmosphere_mass_content_of_ethane_due_to_emission_from_land_transport	kg m-2 s-1		
tendency_of_atmosphere_mass_content_of_ethane_due_to_emission_from_maritime_transport	kg m-2 s-1		
tendency_of_atmosphere_mass_content_of_ethane_due_to_emission_from_residential_and_commercial_combustion	kg m-2 s-1		
tendency_of_atmosphere_mass_content_of_ethane_due_to_emission_from_savanna_and_grassland_fires	kg m-2 s-1		
tendency_of_atmosphere_mass_content_of_ethane_due_to_emission_from_waste_treatment_and_disposal	kg m-2 s-1		
tendency_of_atmosphere_mass_content_of_ethanol_due_to_emission	kg m-2 s-1		
tendency_of_atmosphere_mass_content_of_ethene_due_to_emission	kg m-2 s-1		
tendency_of_atmosphere_mass_content_of_ethene_due_to_emission_from_agricultural_production	kg m-2 s-1		
tendency_of_atmosphere_mass_content_of_ethene_due_to_emission_from_agricultural_waste_burning	kg m-2 s-1		
tendency_of_atmosphere_mass_content_of_ethene_due_to_emission_from_energy_production_and_distribution	kg m-2 s-1		
tendency_of_atmosphere_mass_content_of_ethene_due_to_emission_from_forest_fires	kg m-2 s-1		
tendency_of_atmosphere_mass_content_of_ethene_due_to_emission_from_industrial_processes_and_combustion	kg m-2 s-1		
tendency_of_atmosphere_mass_content_of_ethene_due_to_emission_from_land_transport	kg m-2 s-1		
tendency_of_atmosphere_mass_content_of_ethene_due_to_emission_from_maritime_transport	kg m-2 s-1		
tendency_of_atmosphere_mass_content_of_ethene_due_to_emission_from_residential_and_commercial_combustion	kg m-2 s-1		
tendency_of_atmosphere_mass_content_of_ethene_due_to_emission_from_savanna_and_grassland_fires	kg m-2 s-1		
tendency_of_atmosphere_mass_content_of_ethene_due_to_emission_from_waste_treatment_and_disposal	kg m-2 s-1		
tendency_of_atmosphere_mass_content_of_ethers_due_to_emission_from_agricultural_production	kg m-2 s-1		
tendency_of_atmosphere_mass_content_of_ethers_due_to_emission_from_forest_fires	kg m-2 s-1		
tendency_of_atmosphere_mass_content_of_ethers_due_to_emission_from_land_transport	kg m-2 s-1		
tendency_of_atmosphere_mass_content_of_ethers_due_to_emission_from_residential_and_commercial_combustion	kg m-2 s-1		
tendency_of_atmosphere_mass_content_of_ethers_due_to_emission_from_savanna_and_grassland_fires	kg m-2 s-1		
tendency_of_atmosphere_mass_content_of_ethers_due_to_emission_from_solvent_production_and_use	kg m-2 s-1		
tendency_of_atmosphere_mass_content_of_ethers_due_to_emission_from_waste_treatment_and_disposal	kg m-2 s-1		
tendency_of_atmosphere_mass_content_of_ethyne_due_to_emission	kg m-2 s-1		
tendency_of_atmosphere_mass_content_of_ethyne_due_to_emission_from_agricultural_production	kg m-2 s-1		
tendency_of_atmosphere_mass_content_of_ethyne_due_to_emission_from_agricultural_waste_burning	kg m-2 s-1		
tendency_of_atmosphere_mass_content_of_ethyne_due_to_emission_from_energy_production_and_distribution	kg m-2 s-1		
tendency_of_atmosphere_mass_content_of_ethyne_due_to_emission_from_forest_fires	kg m-2 s-1		
tendency_of_atmosphere_mass_content_of_ethyne_due_to_emission_from_industrial_processes_and_combustion	kg m-2 s-1		
tendency_of_atmosphere_mass_content_of_ethyne_due_to_emission_from_land_transport	kg m-2 s-1		
tendency_of_atmosphere_mass_content_of_ethyne_due_to_emission_from_maritime_transport	kg m-2 s-1		
tendency_of_atmosphere_mass_content_of_ethyne_due_to_emission_from_residential_and_commercial_combustion	kg m-2 s-1		
tendency_of_atmosphere_mass_content_of_ethyne_due_to_emission_from_savanna_and_grassland_fires	kg m-2 s-1		
tendency_of_atmosphere_mass_content_of_ethyne_due_to_emission_from_waste_treatment_and_disposal	kg m-2 s-1		
tendency_of_atmosphere_mass_content_of_formaldehyde_due_to_dry_deposition	kg m-2 s-1		
tendency_of_atmosphere_mass_content_of_formaldehyde_due_to_emission	kg m-2 s-1		
tendency_of_atmosphere_mass_content_of_formaldehyde_due_to_emission_from_agricultural_production	kg m-2 s-1		
tendency_of_atmosphere_mass_content_of_formaldehyde_due_to_emission_from_agricultural_waste_burning	kg m-2 s-1		
tendency_of_atmosphere_mass_content_of_formaldehyde_due_to_emission_from_energy_production_and_distribution	kg m-2 s-1		
tendency_of_atmosphere_mass_content_of_formaldehyde_due_to_emission_from_forest_fires	kg m-2 s-1		
tendency_of_atmosphere_mass_content_of_formaldehyde_due_to_emission_from_industrial_processes_and_combustion	kg m-2 s-1		
tendency_of_atmosphere_mass_content_of_formaldehyde_due_to_emission_from_land_transport	kg m-2 s-1		
tendency_of_atmosphere_mass_content_of_formaldehyde_due_to_emission_from_residential_and_commercial_combustion	kg m-2 s-1		
tendency_of_atmosphere_mass_content_of_formaldehyde_due_to_emission_from_savanna_and_grassland_fires	kg m-2 s-1		
tendency_of_atmosphere_mass_content_of_formaldehyde_due_to_emission_from_waste_treatment_and_disposal	kg m-2 s-1		
tendency_of_atmosphere_mass_content_of_formic_acid_due_to_dry_deposition	kg m-2 s-1		
tendency_of_atmosphere_mass_content_of_formic_acid_due_to_wet_deposition	kg m-2 s-1		
tendency_of_atmosphere_mass_content_of_gaseous_divalent_mercury_due_to_dry_deposition	kg m-2 s-1		
tendency_of_atmosphere_mass_content_of_gaseous_divalent_mercury_due_to_emission	kg m-2 s-1		
tendency_of_atmosphere_mass_content_of_gaseous_divalent_mercury_due_to_wet_deposition	kg m-2 s-1		
tendency_of_atmosphere_mass_content_of_gaseous_elemental_mercury_due_to_dry_deposition	kg m-2 s-1		
tendency_of_atmosphere_mass_content_of_gaseous_elemental_mercury_due_to_emission	kg m-2 s-1		
tendency_of_atmosphere_mass_content_of_gaseous_elemental_mercury_due_to_wet_deposition	kg m-2 s-1		
tendency_of_atmosphere_mass_content_of_halon1202_due_to_emission	kg m-2 s-1		
tendency_of_atmosphere_mass_content_of_halon1211_due_to_emission	kg m-2 s-1		
tendency_of_atmosphere_mass_content_of_halon1301_due_to_emission	kg m-2 s-1		
tendency_of_atmosphere_mass_content_of_halon2402_due_to_emission	kg m-2 s-1		
tendency_of_atmosphere_mass_content_of_hcc140a_due_to_emission	kg m-2 s-1		
tendency_of_atmosphere_mass_content_of_hcfc141b_due_to_emission	kg m-2 s-1		
tendency_of_atmosphere_mass_content_of_hcfc142b_due_to_emission	kg m-2 s-1		
tendency_of_atmosphere_mass_content_of_hcfc22_due_to_emission	kg m-2 s-1		
tendency_of_atmosphere_mass_content_of_hexachlorobiphenyl_due_to_dry_deposition	kg m-2 s-1		
tendency_of_atmosphere_mass_content_of_hexachlorobiphenyl_due_to_emission	kg m-2 s-1		
tendency_of_atmosphere_mass_content_of_hexachlorobiphenyl_due_to_re_emission	kg m-2 s-1		
tendency_of_atmosphere_mass_content_of_hexachlorobiphenyl_due_to_wet_deposition	kg m-2 s-1		
tendency_of_atmosphere_mass_content_of_hydrogen_cyanide_due_to_dry_deposition	kg m-2 s-1		
tendency_of_atmosphere_mass_content_of_hydrogen_cyanide_due_to_emission	kg m-2 s-1		
tendency_of_atmosphere_mass_content_of_hydrogen_peroxide_due_to_dry_deposition	kg m-2 s-1		
tendency_of_atmosphere_mass_content_of_isoprene_due_to_emission	kg m-2 s-1		
tendency_of_atmosphere_mass_content_of_isoprene_due_to_emission_from_forest_fires	kg m-2 s-1		
tendency_of_atmosphere_mass_content_of_isoprene_due_to_emission_from_savanna_and_grassland_fires	kg m-2 s-1		
tendency_of_atmosphere_mass_content_of_ketones_due_to_emission_from_agricultural_production	kg m-2 s-1		
tendency_of_atmosphere_mass_content_of_ketones_due_to_emission_from_agricultural_waste_burning	kg m-2 s-1		
tendency_of_atmosphere_mass_content_of_ketones_due_to_emission_from_energy_production_and_distribution	kg m-2 s-1		
tendency_of_atmosphere_mass_content_of_ketones_due_to_emission_from_forest_fires	kg m-2 s-1		
tendency_of_atmosphere_mass_content_of_ketones_due_to_emission_from_industrial_processes_and_combustion	kg m-2 s-1		
tendency_of_atmosphere_mass_content_of_ketones_due_to_emission_from_land_transport	kg m-2 s-1		
tendency_of_atmosphere_mass_content_of_ketones_due_to_emission_from_residential_and_commercial_combustion	kg m-2 s-1		
tendency_of_atmosphere_mass_content_of_ketones_due_to_emission_from_savanna_and_grassland_fires	kg m-2 s-1		
tendency_of_atmosphere_mass_content_of_ketones_due_to_emission_from_solvent_production_and_use	kg m-2 s-1		
tendency_of_atmosphere_mass_content_of_ketones_due_to_emission_from_waste_treatment_and_disposal	kg m-2 s-1		
tendency_of_atmosphere_mass_content_of_limonene_due_to_emission	kg m-2 s-1		
tendency_of_atmosphere_mass_content_of_mercury_dry_aerosol_due_to_dry_deposition	kg m-2 s-1		
tendency_of_atmosphere_mass_content_of_mercury_dry_aerosol_due_to_emission	kg m-2 s-1		
tendency_of_atmosphere_mass_content_of_mercury_dry_aerosol_due_to_wet_deposition	kg m-2 s-1		
tendency_of_atmosphere_mass_content_of_methane_due_to_emission	kg m-2 s-1		
tendency_of_atmosphere_mass_content_of_methane_due_to_emission_from_agricultural_production	kg m-2 s-1		
tendency_of_atmosphere_mass_content_of_methane_due_to_emission_from_agricultural_waste_burning	kg m-2 s-1		
tendency_of_atmosphere_mass_content_of_methane_due_to_emission_from_energy_production_and_distribution	kg m-2 s-1		
tendency_of_atmosphere_mass_content_of_methane_due_to_emission_from_forest_fires	kg m-2 s-1		
tendency_of_atmosphere_mass_content_of_methane_due_to_emission_from_industrial_processes_and_combustion	kg m-2 s-1		
tendency_of_atmosphere_mass_content_of_methane_due_to_emission_from_land_transport	kg m-2 s-1		
tendency_of_atmosphere_mass_content_of_methane_due_to_emission_from_maritime_transport	kg m-2 s-1		
tendency_of_atmosphere_mass_content_of_methane_due_to_emission_from_residential_and_commercial_combustion	kg m-2 s-1		
tendency_of_atmosphere_mass_content_of_methane_due_to_emission_from_savanna_and_grassland_fires	kg m-2 s-1		
tendency_of_atmosphere_mass_content_of_methane_due_to_emission_from_waste_treatment_and_disposal	kg m-2 s-1		
tendency_of_atmosphere_mass_content_of_methanol_due_to_emission	kg m-2 s-1		
tendency_of_atmosphere_mass_content_of_methyl_bromide_due_to_emission	kg m-2 s-1		
tendency_of_atmosphere_mass_content_of_methyl_chloride_due_to_emission	kg m-2 s-1		
tendency_of_atmosphere_mass_content_of_molecular_hydrogen_due_to_dry_deposition	kg m-2 s-1		
tendency_of_atmosphere_mass_content_of_molecular_hydrogen_due_to_emission	kg m-2 s-1		
tendency_of_atmosphere_mass_content_of_molecular_hydrogen_due_to_emission_from_forest_fires	kg m-2 s-1		
tendency_of_atmosphere_mass_content_of_molecular_hydrogen_due_to_emission_from_savanna_and_grassland_fires	kg m-2 s-1		
tendency_of_atmosphere_mass_content_of_nitrate_dry_aerosol_due_to_dry_deposition	kg m-2 s-1		
tendency_of_atmosphere_mass_content_of_nitric_acid_due_to_dry_deposition	kg m-2 s-1		
tendency_of_atmosphere_mass_content_of_nitric_acid_due_to_wet_deposition	kg m-2 s-1		
tendency_of_atmosphere_mass_content_of_nitrogen_dioxide_due_to_dry_deposition	kg m-2 s-1		
tendency_of_atmosphere_mass_content_of_nitrogen_dioxide_due_to_emission	kg m-2 s-1		
tendency_of_atmosphere_mass_content_of_nitrogen_dioxide_due_to_emission_from_forest_fires	kg m-2 s-1		
tendency_of_atmosphere_mass_content_of_nitrogen_dioxide_due_to_emission_from_savanna_and_grassland_fires	kg m-2 s-1		
tendency_of_atmosphere_mass_content_of_nitrogen_monoxide_due_to_emission	kg m-2 s-1		
tendency_of_atmosphere_mass_content_of_nitrogen_monoxide_due_to_emission_from_agricultural_production	kg m-2 s-1		
tendency_of_atmosphere_mass_content_of_nitrogen_monoxide_due_to_emission_from_agricultural_waste_burning	kg m-2 s-1		
tendency_of_atmosphere_mass_content_of_nitrogen_monoxide_due_to_emission_from_energy_production_and_distribution	kg m-2 s-1		
tendency_of_atmosphere_mass_content_of_nitrogen_monoxide_due_to_emission_from_forest_fires	kg m-2 s-1		
tendency_of_atmosphere_mass_content_of_nitrogen_monoxide_due_to_emission_from_industrial_processes_and_combustion	kg m-2 s-1		
tendency_of_atmosphere_mass_content_of_nitrogen_monoxide_due_to_emission_from_land_transport	kg m-2 s-1		
tendency_of_atmosphere_mass_content_of_nitrogen_monoxide_due_to_emission_from_maritime_transport	kg m-2 s-1		
tendency_of_atmosphere_mass_content_of_nitrogen_monoxide_due_to_emission_from_residential_and_commercial_combustion	kg m-2 s-1		
tendency_of_atmosphere_mass_content_of_nitrogen_monoxide_due_to_emission_from_savanna_and_grassland_fires	kg m-2 s-1		
tendency_of_atmosphere_mass_content_of_nitrogen_monoxide_due_to_emission_from_waste_treatment_and_disposal	kg m-2 s-1		
tendency_of_atmosphere_mass_content_of_nitrous_acid_due_to_dry_deposition	kg m-2 s-1		
tendency_of_atmosphere_mass_content_of_nitrous_acid_due_to_emission	kg m-2 s-1		
tendency_of_atmosphere_mass_content_of_nitrous_oxide_due_to_dry_deposition	kg m-2 s-1		
tendency_of_atmosphere_mass_content_of_nitrous_oxide_due_to_emission	kg m-2 s-1		
tendency_of_atmosphere_mass_content_of_nmvoc_due_to_emission_from_agricultural_production	kg m-2 s-1		
tendency_of_atmosphere_mass_content_of_nmvoc_due_to_emission_from_agricultural_waste_burning	kg m-2 s-1		
tendency_of_atmosphere_mass_content_of_nmvoc_due_to_emission_from_energy_production_and_distribution	kg m-2 s-1		
tendency_of_atmosphere_mass_content_of_nmvoc_due_to_emission_from_forest_fires	kg m-2 s-1		
tendency_of_atmosphere_mass_content_of_nmvoc_due_to_emission_from_industrial_processes_and_combustion	kg m-2 s-1		
tendency_of_atmosphere_mass_content_of_nmvoc_due_to_emission_from_land_transport	kg m-2 s-1		
tendency_of_atmosphere_mass_content_of_nmvoc_due_to_emission_from_maritime_transport	kg m-2 s-1		
tendency_of_atmosphere_mass_content_of_nmvoc_due_to_emission_from_residential_and_commercial_combustion	kg m-2 s-1		
tendency_of_atmosphere_mass_content_of_nmvoc_due_to_emission_from_savanna_and_grassland_fires	kg m-2 s-1		
tendency_of_atmosphere_mass_content_of_nmvoc_due_to_emission_from_solvent_production_and_use	kg m-2 s-1		
tendency_of_atmosphere_mass_content_of_nmvoc_due_to_emission_from_waste_treatment_and_disposal	kg m-2 s-1		
tendency_of_atmosphere_mass_content_of_nox_expressed_as_nitrogen_due_to_emission	kg m-2 s-1		
tendency_of_atmosphere_mass_content_of_nox_expressed_as_nitrogen_monoxide_due_to_emission_from_agricultural_production	kg m-2 s-1		
tendency_of_atmosphere_mass_content_of_nox_expressed_as_nitrogen_monoxide_due_to_emission_from_agricultural_waste_burning	kg m-2 s-1		
tendency_of_atmosphere_mass_content_of_nox_expressed_as_nitrogen_monoxide_due_to_emission_from_energy_production_and_distribution	kg m-2 s-1		
tendency_of_atmosphere_mass_content_of_nox_expressed_as_nitrogen_monoxide_due_to_emission_from_forest_fires	kg m-2 s-1		
tendency_of_atmosphere_mass_content_of_nox_expressed_as_nitrogen_monoxide_due_to_emission_from_industrial_processes_and_combustion	kg m-2 s-1		
tendency_of_atmosphere_mass_content_of_nox_expressed_as_nitrogen_monoxide_due_to_emission_from_land_transport	kg m-2 s-1		
tendency_of_atmosphere_mass_content_of_nox_expressed_as_nitrogen_monoxide_due_to_emission_from_maritime_transport	kg m-2 s-1		
tendency_of_atmosphere_mass_content_of_nox_expressed_as_nitrogen_monoxide_due_to_emission_from_residential_and_commercial_combustion	kg m-2 s-1		
tendency_of_atmosphere_mass_content_of_nox_expressed_as_nitrogen_monoxide_due_to_emission_from_savanna_and_grassland_fires	kg m-2 s-1		
tendency_of_atmosphere_mass_content_of_nox_expressed_as_nitrogen_monoxide_due_to_emission_from_waste_treatment_and_disposal	kg m-2 s-1		
tendency_of_atmosphere_mass_content_of_organic_acids_due_to_emission_from_agricultural_production	kg m-2 s-1		
tendency_of_atmosphere_mass_content_of_organic_acids_due_to_emission_from_agricultural_waste_burning	kg m-2 s-1		
tendency_of_atmosphere_mass_content_of_organic_acids_due_to_emission_from_energy_production_and_distribution	kg m-2 s-1		
tendency_of_atmosphere_mass_content_of_organic_acids_due_to_emission_from_forest_fires	kg m-2 s-1		
tendency_of_atmosphere_mass_content_of_organic_acids_due_to_emission_from_industrial_processes_and_combustion	kg m-2 s-1		
tendency_of_atmosphere_mass_content_of_organic_acids_due_to_emission_from_residential_and_commercial_combustion	kg m-2 s-1		
tendency_of_atmosphere_mass_content_of_organic_acids_due_to_emission_from_savanna_and_grassland_fires	kg m-2 s-1		
tendency_of_atmosphere_mass_content_of_organic_acids_due_to_emission_from_waste_treatment_and_disposal	kg m-2 s-1		
tendency_of_atmosphere_mass_content_of_ozone_due_to_dry_deposition	kg m-2 s-1		
tendency_of_atmosphere_mass_content_of_ozone_due_to_dry_deposition_into_stomata	kg m-2 s-1		
tendency_of_atmosphere_mass_content_of_particulate_organic_matter_dry_aerosol_due_to_dry_deposition	kg m-2 s-1		
tendency_of_atmosphere_mass_content_of_particulate_organic_matter_dry_aerosol_due_to_gravitational_settling	kg m-2 s-1		
tendency_of_atmosphere_mass_content_of_particulate_organic_matter_dry_aerosol_due_to_net_chemical_production_and_emission
alias: tendency_of_atmosphere_mass_content_of_particulate_organic_matter_dry_aerosol_due_to_net_production_and_emission
kg m-2 s-1		
tendency_of_atmosphere_mass_content_of_particulate_organic_matter_dry_aerosol_due_to_turbulent_deposition	kg m-2 s-1		
tendency_of_atmosphere_mass_content_of_particulate_organic_matter_dry_aerosol_due_to_wet_deposition	kg m-2 s-1		
tendency_of_atmosphere_mass_content_of_particulate_organic_matter_dry_aerosol_expressed_as_carbon_due_to_emission_from_agricultural_waste_burning	kg m-2 s-1		
tendency_of_atmosphere_mass_content_of_particulate_organic_matter_dry_aerosol_expressed_as_carbon_due_to_emission_from_energy_production_and_distribution	kg m-2 s-1		
tendency_of_atmosphere_mass_content_of_particulate_organic_matter_dry_aerosol_expressed_as_carbon_due_to_emission_from_forest_fires	kg m-2 s-1		
tendency_of_atmosphere_mass_content_of_particulate_organic_matter_dry_aerosol_expressed_as_carbon_due_to_emission_from_industrial_processes_and_combustion	kg m-2 s-1		
tendency_of_atmosphere_mass_content_of_particulate_organic_matter_dry_aerosol_expressed_as_carbon_due_to_emission_from_land_transport	kg m-2 s-1		
tendency_of_atmosphere_mass_content_of_particulate_organic_matter_dry_aerosol_expressed_as_carbon_due_to_emission_from_maritime_transport	kg m-2 s-1		
tendency_of_atmosphere_mass_content_of_particulate_organic_matter_dry_aerosol_expressed_as_carbon_due_to_emission_from_residential_and_commercial_combustion	kg m-2 s-1		
tendency_of_atmosphere_mass_content_of_particulate_organic_matter_dry_aerosol_expressed_as_carbon_due_to_emission_from_savanna_and_grassland_fires	kg m-2 s-1		
tendency_of_atmosphere_mass_content_of_particulate_organic_matter_dry_aerosol_expressed_as_carbon_due_to_emission_from_waste_treatment_and_disposal	kg m-2 s-1		
tendency_of_atmosphere_mass_content_of_pentane_due_to_emission_from_agricultural_production	kg m-2 s-1		
tendency_of_atmosphere_mass_content_of_pentane_due_to_emission_from_agricultural_waste_burning	kg m-2 s-1		
tendency_of_atmosphere_mass_content_of_pentane_due_to_emission_from_forest_fires	kg m-2 s-1		
tendency_of_atmosphere_mass_content_of_pentane_due_to_emission_from_industrial_processes_and_combustion	kg m-2 s-1		
tendency_of_atmosphere_mass_content_of_pentane_due_to_emission_from_land_transport	kg m-2 s-1		
tendency_of_atmosphere_mass_content_of_pentane_due_to_emission_from_maritime_transport	kg m-2 s-1		
tendency_of_atmosphere_mass_content_of_pentane_due_to_emission_from_residential_and_commercial_combustion	kg m-2 s-1		
tendency_of_atmosphere_mass_content_of_pentane_due_to_emission_from_savanna_and_grassland_fires	kg m-2 s-1		
tendency_of_atmosphere_mass_content_of_pentane_due_to_emission_from_waste_treatment_and_disposal	kg m-2 s-1		
tendency_of_atmosphere_mass_content_of_peroxyacetyl_nitrate_due_to_dry_deposition	kg m-2 s-1		
tendency_of_atmosphere_mass_content_of_peroxynitric_acid_due_to_dry_deposition	kg m-2 s-1		
tendency_of_atmosphere_mass_content_of_primary_particulate_organic_matter_dry_aerosol_due_to_dry_deposition	kg m-2 s-1		
tendency_of_atmosphere_mass_content_of_primary_particulate_organic_matter_dry_aerosol_due_to_emission	kg m-2 s-1		
tendency_of_atmosphere_mass_content_of_primary_particulate_organic_matter_dry_aerosol_due_to_wet_deposition	kg m-2 s-1		
tendency_of_atmosphere_mass_content_of_propane_due_to_emission	kg m-2 s-1		
tendency_of_atmosphere_mass_content_of_propane_due_to_emission_from_agricultural_production	kg m-2 s-1		
tendency_of_atmosphere_mass_content_of_propane_due_to_emission_from_agricultural_waste_burning	kg m-2 s-1		
tendency_of_atmosphere_mass_content_of_propane_due_to_emission_from_energy_production_and_distribution	kg m-2 s-1		
tendency_of_atmosphere_mass_content_of_propane_due_to_emission_from_forest_fires	kg m-2 s-1		
tendency_of_atmosphere_mass_content_of_propane_due_to_emission_from_industrial_processes_and_combustion	kg m-2 s-1		
tendency_of_atmosphere_mass_content_of_propane_due_to_emission_from_land_transport	kg m-2 s-1		
tendency_of_atmosphere_mass_content_of_propane_due_to_emission_from_maritime_transport	kg m-2 s-1		
tendency_of_atmosphere_mass_content_of_propane_due_to_emission_from_residential_and_commercial_combustion	kg m-2 s-1		
tendency_of_atmosphere_mass_content_of_propane_due_to_emission_from_savanna_and_grassland_fires	kg m-2 s-1		
tendency_of_atmosphere_mass_content_of_propane_due_to_emission_from_waste_treatment_and_disposal	kg m-2 s-1		
tendency_of_atmosphere_mass_content_of_propene_due_to_emission	kg m-2 s-1		
tendency_of_atmosphere_mass_content_of_propene_due_to_emission_from_agricultural_production	kg m-2 s-1		
tendency_of_atmosphere_mass_content_of_propene_due_to_emission_from_agricultural_waste_burning	kg m-2 s-1		
tendency_of_atmosphere_mass_content_of_propene_due_to_emission_from_energy_production_and_distribution	kg m-2 s-1		
tendency_of_atmosphere_mass_content_of_propene_due_to_emission_from_forest_fires	kg m-2 s-1		
tendency_of_atmosphere_mass_content_of_propene_due_to_emission_from_industrial_processes_and_combustion	kg m-2 s-1		
tendency_of_atmosphere_mass_content_of_propene_due_to_emission_from_land_transport	kg m-2 s-1		
tendency_of_atmosphere_mass_content_of_propene_due_to_emission_from_maritime_transport	kg m-2 s-1		
tendency_of_atmosphere_mass_content_of_propene_due_to_emission_from_residential_and_commercial_combustion	kg m-2 s-1		
tendency_of_atmosphere_mass_content_of_propene_due_to_emission_from_savanna_and_grassland_fires	kg m-2 s-1		
tendency_of_atmosphere_mass_content_of_propene_due_to_emission_from_waste_treatment_and_disposal	kg m-2 s-1		
tendency_of_atmosphere_mass_content_of_radon_due_to_emission	kg m-2 s-1		
tendency_of_atmosphere_mass_content_of_seasalt_dry_aerosol_due_to_dry_deposition	kg m-2 s-1		
tendency_of_atmosphere_mass_content_of_seasalt_dry_aerosol_due_to_emission	kg m-2 s-1		
tendency_of_atmosphere_mass_content_of_seasalt_dry_aerosol_due_to_gravitational_settling	kg m-2 s-1		
tendency_of_atmosphere_mass_content_of_seasalt_dry_aerosol_due_to_turbulent_deposition	kg m-2 s-1		
tendency_of_atmosphere_mass_content_of_seasalt_dry_aerosol_due_to_wet_deposition	kg m-2 s-1		
tendency_of_atmosphere_mass_content_of_secondary_particulate_organic_matter_dry_aerosol_due_to_dry_deposition	kg m-2 s-1		
tendency_of_atmosphere_mass_content_of_secondary_particulate_organic_matter_dry_aerosol_due_to_net_chemical_production
alias: tendency_of_atmosphere_mass_content_of_secondary_particulate_organic_matter_dry_aerosol_due_to_net_production
kg m-2 s-1		
tendency_of_atmosphere_mass_content_of_secondary_particulate_organic_matter_dry_aerosol_due_to_wet_deposition	kg m-2 s-1		
tendency_of_atmosphere_mass_content_of_sulfate_dry_aerosol_due_to_dry_deposition	kg m-2 s-1		
tendency_of_atmosphere_mass_content_of_sulfate_dry_aerosol_due_to_emission	kg m-2 s-1		
tendency_of_atmosphere_mass_content_of_sulfate_dry_aerosol_expressed_as_sulfur_due_to_dry_deposition
alias: tendency_of_atmosphere_mass_content_of_sulfate_expressed_as_sulfur_dry_aerosol_due_to_dry_deposition
kg m-2 s-1		
tendency_of_atmosphere_mass_content_of_sulfate_dry_aerosol_expressed_as_sulfur_due_to_gravitational_settling
alias: tendency_of_atmosphere_mass_content_of_sulfate_expressed_as_sulfur_dry_aerosol_due_to_gravitational_settling
kg m-2 s-1		
tendency_of_atmosphere_mass_content_of_sulfate_dry_aerosol_expressed_as_sulfur_due_to_turbulent_deposition
alias: tendency_of_atmosphere_mass_content_of_sulfate_expressed_as_sulfur_dry_aerosol_due_to_turbulent_deposition
kg m-2 s-1		
tendency_of_atmosphere_mass_content_of_sulfate_dry_aerosol_expressed_as_sulfur_due_to_wet_deposition
alias: tendency_of_atmosphere_mass_content_of_sulfate_expressed_as_sulfur_dry_aerosol_due_to_wet_deposition
kg m-2 s-1		
tendency_of_atmosphere_mass_content_of_sulfur_dioxide_due_to_dry_deposition	kg m-2 s-1		
tendency_of_atmosphere_mass_content_of_sulfur_dioxide_due_to_emission	kg m-2 s-1		
tendency_of_atmosphere_mass_content_of_sulfur_dioxide_due_to_emission_from_agricultural_waste_burning	kg m-2 s-1		
tendency_of_atmosphere_mass_content_of_sulfur_dioxide_due_to_emission_from_energy_production_and_distribution	kg m-2 s-1		
tendency_of_atmosphere_mass_content_of_sulfur_dioxide_due_to_emission_from_forest_fires	kg m-2 s-1		
tendency_of_atmosphere_mass_content_of_sulfur_dioxide_due_to_emission_from_industrial_processes_and_combustion	kg m-2 s-1		
tendency_of_atmosphere_mass_content_of_sulfur_dioxide_due_to_emission_from_land_transport	kg m-2 s-1		
tendency_of_atmosphere_mass_content_of_sulfur_dioxide_due_to_emission_from_maritime_transport	kg m-2 s-1		
tendency_of_atmosphere_mass_content_of_sulfur_dioxide_due_to_emission_from_residential_and_commercial_combustion	kg m-2 s-1		
tendency_of_atmosphere_mass_content_of_sulfur_dioxide_due_to_emission_from_savanna_and_grassland_fires	kg m-2 s-1		
tendency_of_atmosphere_mass_content_of_sulfur_dioxide_due_to_emission_from_waste_treatment_and_disposal	kg m-2 s-1		
tendency_of_atmosphere_mass_content_of_sulfur_dioxide_due_to_wet_deposition	kg m-2 s-1		
tendency_of_atmosphere_mass_content_of_terpenes_due_to_emission_from_forest_fires	kg m-2 s-1		
tendency_of_atmosphere_mass_content_of_terpenes_due_to_emission_from_savanna_and_grassland_fires	kg m-2 s-1		
tendency_of_atmosphere_mass_content_of_toluene_due_to_emission	kg m-2 s-1		
tendency_of_atmosphere_mass_content_of_toluene_due_to_emission_from_agricultural_production	kg m-2 s-1		
tendency_of_atmosphere_mass_content_of_toluene_due_to_emission_from_agricultural_waste_burning	kg m-2 s-1		
tendency_of_atmosphere_mass_content_of_toluene_due_to_emission_from_energy_production_and_distribution	kg m-2 s-1		
tendency_of_atmosphere_mass_content_of_toluene_due_to_emission_from_forest_fires	kg m-2 s-1		
tendency_of_atmosphere_mass_content_of_toluene_due_to_emission_from_industrial_processes_and_combustion	kg m-2 s-1		
tendency_of_atmosphere_mass_content_of_toluene_due_to_emission_from_land_transport	kg m-2 s-1		
tendency_of_atmosphere_mass_content_of_toluene_due_to_emission_from_maritime_transport	kg m-2 s-1		
tendency_of_atmosphere_mass_content_of_toluene_due_to_emission_from_residential_and_commercial_combustion	kg m-2 s-1		
tendency_of_atmosphere_mass_content_of_toluene_due_to_emission_from_savanna_and_grassland_fires	kg m-2 s-1		
tendency_of_atmosphere_mass_content_of_toluene_due_to_emission_from_solvent_production_and_use	kg m-2 s-1		
tendency_of_atmosphere_mass_content_of_toluene_due_to_emission_from_waste_treatment_and_disposal	kg m-2 s-1		
tendency_of_atmosphere_mass_content_of_trimethylbenzene_due_to_emission_from_energy_production_and_distribution	kg m-2 s-1		
tendency_of_atmosphere_mass_content_of_water_due_to_advection
alias: tendency_of_atmosphere_water_content_due_to_advection
kg m-2 s-1		
tendency_of_atmosphere_mass_content_of_water_vapor
alias: tendency_of_atmosphere_water_vapor_content
kg m-2 s-1		
tendency_of_atmosphere_mass_content_of_water_vapor_due_to_advection
alias: tendency_of_atmosphere_water_vapor_content_due_to_advection
kg m-2 s-1		
tendency_of_atmosphere_mass_content_of_water_vapor_due_to_convection
alias: tendency_of_atmosphere_water_vapor_content_due_to_convection
kg m-2 s-1		
tendency_of_atmosphere_mass_content_of_water_vapor_due_to_deep_convection
alias: tendency_of_atmosphere_water_vapor_content_due_to_deep_convection
kg m-2 s-1		
tendency_of_atmosphere_mass_content_of_water_vapor_due_to_shallow_convection
alias: tendency_of_atmosphere_water_vapor_content_due_to_shallow_convection
kg m-2 s-1		
tendency_of_atmosphere_mass_content_of_water_vapor_due_to_turbulence
alias: tendency_of_atmosphere_water_vapor_content_due_to_turbulence
kg m-2 s-1		
tendency_of_atmosphere_mass_content_of_xylene_due_to_emission	kg m-2 s-1		
tendency_of_atmosphere_mass_content_of_xylene_due_to_emission_from_agricultural_production	kg m-2 s-1		
tendency_of_atmosphere_mass_content_of_xylene_due_to_emission_from_agricultural_waste_burning	kg m-2 s-1		
tendency_of_atmosphere_mass_content_of_xylene_due_to_emission_from_energy_production_and_distribution	kg m-2 s-1		
tendency_of_atmosphere_mass_content_of_xylene_due_to_emission_from_forest_fires	kg m-2 s-1		
tendency_of_atmosphere_mass_content_of_xylene_due_to_emission_from_industrial_processes_and_combustion	kg m-2 s-1		
tendency_of_atmosphere_mass_content_of_xylene_due_to_emission_from_land_transport	kg m-2 s-1		
tendency_of_atmosphere_mass_content_of_xylene_due_to_emission_from_maritime_transport	kg m-2 s-1		
tendency_of_atmosphere_mass_content_of_xylene_due_to_emission_from_residential_and_commercial_combustion	kg m-2 s-1		
tendency_of_atmosphere_mass_content_of_xylene_due_to_emission_from_savanna_and_grassland_fires	kg m-2 s-1		
tendency_of_atmosphere_mass_content_of_xylene_due_to_emission_from_solvent_production_and_use	kg m-2 s-1		
tendency_of_atmosphere_mass_content_of_xylene_due_to_emission_from_waste_treatment_and_disposal	kg m-2 s-1		
tendency_of_atmosphere_mass_per_unit_area	kg m-2 s-1		
tendency_of_atmosphere_mass_per_unit_area_due_to_advection	kg m-2 s-1		
tendency_of_atmosphere_moles_of_acetic_acid	mol s-1		
tendency_of_atmosphere_moles_of_aceto_nitrile	mol s-1		
tendency_of_atmosphere_moles_of_alpha_hexachlorocyclohexane	mol s-1		
tendency_of_atmosphere_moles_of_alpha_pinene	mol s-1		
tendency_of_atmosphere_moles_of_ammonia	mol s-1		
tendency_of_atmosphere_moles_of_anthropogenic_nmvoc_expressed_as_carbon	mol s-1		
tendency_of_atmosphere_moles_of_atomic_bromine	mol s-1		
tendency_of_atmosphere_moles_of_atomic_chlorine	mol s-1		
tendency_of_atmosphere_moles_of_atomic_nitrogen	mol s-1		
tendency_of_atmosphere_moles_of_benzene	mol s-1		
tendency_of_atmosphere_moles_of_beta_pinene	mol s-1		
tendency_of_atmosphere_moles_of_biogenic_nmvoc_expressed_as_carbon	mol s-1		
tendency_of_atmosphere_moles_of_bromine_chloride	mol s-1		
tendency_of_atmosphere_moles_of_bromine_monoxide	mol s-1		
tendency_of_atmosphere_moles_of_bromine_nitrate	mol s-1		
tendency_of_atmosphere_moles_of_brox_expressed_as_bromine	mol s-1		
tendency_of_atmosphere_moles_of_butane	mol s-1		
tendency_of_atmosphere_moles_of_carbon_dioxide	mol s-1		
tendency_of_atmosphere_moles_of_carbon_monoxide
alias: tendency_of_moles_of_carbon_monoxide_in_atmosphere
mol s-1		
tendency_of_atmosphere_moles_of_carbon_tetrachloride
alias: tendency_of_moles_of_carbon_tetrachloride_in_atmosphere
mol s-1		
tendency_of_atmosphere_moles_of_cfc11
alias: tendency_of_moles_of_cfc11_in_atmosphere
mol s-1		
tendency_of_atmosphere_moles_of_cfc113
alias: tendency_of_moles_of_cfc113_in_atmosphere
mol s-1		
tendency_of_atmosphere_moles_of_cfc113a	mol s-1		
tendency_of_atmosphere_moles_of_cfc114
alias: tendency_of_moles_of_cfc114_in_atmosphere
mol s-1		
tendency_of_atmosphere_moles_of_cfc115
alias: tendency_of_moles_of_cfc115_in_atmosphere
mol s-1		
tendency_of_atmosphere_moles_of_cfc12
alias: tendency_of_moles_of_cfc12_in_atmosphere
mol s-1		
tendency_of_atmosphere_moles_of_chlorine_dioxide	mol s-1		
tendency_of_atmosphere_moles_of_chlorine_monoxide	mol s-1		
tendency_of_atmosphere_moles_of_chlorine_nitrate	mol s-1		
tendency_of_atmosphere_moles_of_clox_expressed_as_chlorine	mol s-1		
tendency_of_atmosphere_moles_of_dichlorine_peroxide	mol s-1		
tendency_of_atmosphere_moles_of_dimethyl_sulfide	mol s-1		
tendency_of_atmosphere_moles_of_dinitrogen_pentoxide	mol s-1		
tendency_of_atmosphere_moles_of_ethane	mol s-1		
tendency_of_atmosphere_moles_of_ethanol	mol s-1		
tendency_of_atmosphere_moles_of_ethene	mol s-1		
tendency_of_atmosphere_moles_of_ethyne	mol s-1		
tendency_of_atmosphere_moles_of_formaldehyde	mol s-1		
tendency_of_atmosphere_moles_of_formic_acid	mol s-1		
tendency_of_atmosphere_moles_of_gaseous_divalent_mercury	mol s-1		
tendency_of_atmosphere_moles_of_gaseous_elemental_mercury	mol s-1		
tendency_of_atmosphere_moles_of_halon1202
alias: tendency_of_moles_of_halon1202_in_atmosphere
mol s-1		
tendency_of_atmosphere_moles_of_halon1211
alias: tendency_of_moles_of_halon1211_in_atmosphere
mol s-1		
tendency_of_atmosphere_moles_of_halon1301
alias: tendency_of_moles_of_halon1301_in_atmosphere
mol s-1		
tendency_of_atmosphere_moles_of_halon2402
alias: tendency_of_moles_of_halon2402_in_atmosphere
mol s-1		
tendency_of_atmosphere_moles_of_hcc140a
alias: tendency_of_moles_of_hcc140a_in_atmosphere
mol s-1		
tendency_of_atmosphere_moles_of_hcfc141b	mol s-1		
tendency_of_atmosphere_moles_of_hcfc142b	mol s-1		
tendency_of_atmosphere_moles_of_hcfc22
alias: tendency_of_moles_of_hcfc22_in_atmosphere
mol s-1		
tendency_of_atmosphere_moles_of_hexachlorobiphenyl	mol s-1		
tendency_of_atmosphere_moles_of_hox_expressed_as_hydrogen	mol s-1		
tendency_of_atmosphere_moles_of_hydrogen_bromide	mol s-1		
tendency_of_atmosphere_moles_of_hydrogen_chloride	mol s-1		
tendency_of_atmosphere_moles_of_hydrogen_cyanide	mol s-1		
tendency_of_atmosphere_moles_of_hydrogen_peroxide	mol s-1		
tendency_of_atmosphere_moles_of_hydroperoxyl_radical	mol s-1		
tendency_of_atmosphere_moles_of_hydroxyl_radical	mol s-1		
tendency_of_atmosphere_moles_of_hypobromous_acid	mol s-1		
tendency_of_atmosphere_moles_of_hypochlorous_acid	mol s-1		
tendency_of_atmosphere_moles_of_inorganic_bromine	mol s-1		
tendency_of_atmosphere_moles_of_inorganic_chlorine	mol s-1		
tendency_of_atmosphere_moles_of_isoprene	mol s-1		
tendency_of_atmosphere_moles_of_limonene	mol s-1		
tendency_of_atmosphere_moles_of_methane
alias: tendency_of_moles_of_methane_in_atmosphere
mol s-1		
tendency_of_atmosphere_moles_of_methanol	mol s-1		
tendency_of_atmosphere_moles_of_methyl_bromide
alias: tendency_of_moles_of_methyl_bromide_in_atmosphere
mol s-1		
tendency_of_atmosphere_moles_of_methyl_chloride
alias: tendency_of_moles_of_methyl_chloride_in_atmosphere
mol s-1		
tendency_of_atmosphere_moles_of_methyl_hydroperoxide	mol s-1		
tendency_of_atmosphere_moles_of_methyl_peroxy_radical	mol s-1		
tendency_of_atmosphere_moles_of_molecular_hydrogen
alias: tendency_of_moles_of_molecular_hydrogen_in_atmosphere
mol s-1		
tendency_of_atmosphere_moles_of_nitrate_radical	mol s-1		
tendency_of_atmosphere_moles_of_nitric_acid	mol s-1		
tendency_of_atmosphere_moles_of_nitric_acid_trihydrate_ambient_aerosol	mol s-1		
tendency_of_atmosphere_moles_of_nitrogen_dioxide	mol s-1		
tendency_of_atmosphere_moles_of_nitrogen_monoxide	mol s-1		
tendency_of_atmosphere_moles_of_nitrous_acid	mol s-1		
tendency_of_atmosphere_moles_of_nitrous_oxide
alias: tendency_of_moles_of_nitrous_oxide_in_atmosphere
mol s-1		
tendency_of_atmosphere_moles_of_nmvoc_expressed_as_carbon	mol s-1		
tendency_of_atmosphere_moles_of_nox_expressed_as_nitrogen	mol s-1		
tendency_of_atmosphere_moles_of_noy_expressed_as_nitrogen	mol s-1		
tendency_of_atmosphere_moles_of_ozone	mol s-1		
tendency_of_atmosphere_moles_of_peroxyacetyl_nitrate	mol s-1		
tendency_of_atmosphere_moles_of_peroxynitric_acid	mol s-1		
tendency_of_atmosphere_moles_of_propane	mol s-1		
tendency_of_atmosphere_moles_of_propene	mol s-1		
tendency_of_atmosphere_moles_of_radon	mol s-1		
tendency_of_atmosphere_moles_of_sulfate_dry_aerosol	mol s-1		
tendency_of_atmosphere_moles_of_sulfur_dioxide	mol s-1		
tendency_of_atmosphere_moles_of_toluene	mol s-1		
tendency_of_atmosphere_moles_of_water_vapor	mol s-1		
tendency_of_atmosphere_moles_of_xylene	mol s-1		
tendency_of_atmosphere_number_content_of_aerosol_particles_due_to_dry_deposition	m-2 s-2		
tendency_of_atmosphere_number_content_of_aerosol_particles_due_to_gravitational_settling	m-2 s-1		
tendency_of_atmosphere_number_content_of_aerosol_particles_due_to_turbulent_depostion	m-2 s-1		
tendency_of_atmosphere_number_content_of_aerosol_particles_due_to_wet_deposition	m-2 s-1		
tendency_of_atmosphere_potential_energy_content_due_to_advection	W m-2		
tendency_of_bedrock_altitude	m s-1		
tendency_of_dry_energy_content_of_atmosphere_layer	W m-2		
tendency_of_dry_static_energy_content_of_atmosphere_layer	W m-2		
tendency_of_eastward_wind	m s-2	tnmmutot	
tendency_of_eastward_wind_due_to_advection	m s-2		
tendency_of_eastward_wind_due_to_convection	m s-2	tnmmuc	
tendency_of_eastward_wind_due_to_diffusion	m s-2		
tendency_of_eastward_wind_due_to_eliassen_palm_flux_divergence	m s-2		
tendency_of_eastward_wind_due_to_gravity_wave_drag	m s-2	tnmmugwd	
tendency_of_eastward_wind_due_to_nonorographic_gravity_wave_drag	m s-2		
tendency_of_eastward_wind_due_to_numerical_artefacts	m s-2		
tendency_of_eastward_wind_due_to_orographic_gravity_wave_drag	m s-2		
tendency_of_enthalpy_content_of_atmosphere_layer_due_to_advection	W m-2		
tendency_of_global_average_sea_level_change	m year-1		
tendency_of_kinetic_energy_content_of_atmosphere_layer_due_to_advection	W m-2		
tendency_of_land_ice_thickness	m s-1		
tendency_of_mass_concentration_of_black_carbon_dry_aerosol_in_air_due_to_emission_from_aviation	kg m-3 s-1		
tendency_of_mass_concentration_of_nitrogen_dioxide_in_air_due_to_emission_from_aviation	kg m-3 s-1		
tendency_of_mass_concentration_of_nitrogen_monoxide_in_air_due_to_emission_from_aviation	kg m-3 s-1		
tendency_of_mass_concentration_of_nox_expressed_as_nitrogen_monoxide_in_air_due_to_emission_from_aviation	kg m-3 s-1		
tendency_of_mass_content_of_water_vapor_in_atmosphere_layer
alias: tendency_of_water_vapor_content_of_atmosphere_layer
kg m-2 s-1		
tendency_of_mass_content_of_water_vapor_in_atmosphere_layer_due_to_convection
alias: tendency_of_water_vapor_content_of_atmosphere_layer_due_to_convection
kg m-2 s-1		
tendency_of_mass_content_of_water_vapor_in_atmosphere_layer_due_to_deep_convection
alias: tendency_of_water_vapor_content_of_atmosphere_layer_due_to_deep_convection
kg m-2 s-1		
tendency_of_mass_content_of_water_vapor_in_atmosphere_layer_due_to_shallow_convection
alias: tendency_of_water_vapor_content_of_atmosphere_layer_due_to_shallow_convection
kg m-2 s-1		
tendency_of_mass_content_of_water_vapor_in_atmosphere_layer_due_to_turbulence
alias: tendency_of_water_vapor_content_of_atmosphere_layer_due_to_turbulence
kg m-2 s-1		
tendency_of_mass_fraction_of_cloud_condensed_water_in_air	s-1		
tendency_of_mass_fraction_of_cloud_condensed_water_in_air_due_to_advection	s-1		
tendency_of_mass_fraction_of_cloud_ice_in_air	s-1		
tendency_of_mass_fraction_of_cloud_ice_in_air_due_to_advection	s-1		
tendency_of_mass_fraction_of_cloud_ice_in_air_due_to_diffusion	s-1		
tendency_of_mass_fraction_of_cloud_liquid_water_in_air	s-1		
tendency_of_mass_fraction_of_cloud_liquid_water_in_air_due_to_advection	s-1		
tendency_of_mass_fraction_of_cloud_liquid_water_in_air_due_to_diffusion	s-1		
tendency_of_mass_fraction_of_stratiform_cloud_condensed_water_in_air	s-1		
tendency_of_mass_fraction_of_stratiform_cloud_condensed_water_in_air_due_to_advection	s-1		
tendency_of_mass_fraction_of_stratiform_cloud_condensed_water_in_air_due_to_autoconversion_to_rain	s-1		
tendency_of_mass_fraction_of_stratiform_cloud_condensed_water_in_air_due_to_autoconversion_to_snow	s-1		
tendency_of_mass_fraction_of_stratiform_cloud_condensed_water_in_air_due_to_boundary_layer_mixing	s-1		
tendency_of_mass_fraction_of_stratiform_cloud_condensed_water_in_air_due_to_cloud_microphysics	s-1		
tendency_of_mass_fraction_of_stratiform_cloud_condensed_water_in_air_due_to_condensation_and_evaporation	s-1		
tendency_of_mass_fraction_of_stratiform_cloud_condensed_water_in_air_due_to_icefall	s-1		
tendency_of_mass_fraction_of_stratiform_cloud_ice_in_air	s-1		
tendency_of_mass_fraction_of_stratiform_cloud_ice_in_air_due_to_accretion_to_snow	s-1		
tendency_of_mass_fraction_of_stratiform_cloud_ice_in_air_due_to_advection	s-1		
tendency_of_mass_fraction_of_stratiform_cloud_ice_in_air_due_to_aggregation	s-1		
tendency_of_mass_fraction_of_stratiform_cloud_ice_in_air_due_to_bergeron_findeisen_process_from_cloud_liquid	s-1		
tendency_of_mass_fraction_of_stratiform_cloud_ice_in_air_due_to_boundary_layer_mixing	s-1		
tendency_of_mass_fraction_of_stratiform_cloud_ice_in_air_due_to_cloud_microphysics	s-1		
tendency_of_mass_fraction_of_stratiform_cloud_ice_in_air_due_to_convective_detrainment	s-1		
tendency_of_mass_fraction_of_stratiform_cloud_ice_in_air_due_to_deposition_and_sublimation	s-1		
tendency_of_mass_fraction_of_stratiform_cloud_ice_in_air_due_to_evaporation_of_melting_ice	s-1		
tendency_of_mass_fraction_of_stratiform_cloud_ice_in_air_due_to_heterogeneous_nucleation_from_cloud_liquid_water
alias: tendency_of_mass_fraction_of_stratiform_cloud_ice_in_air_due_to_heterogeneous_nucleation_from_cloud_liquid
s-1		
tendency_of_mass_fraction_of_stratiform_cloud_ice_in_air_due_to_heterogeneous_nucleation_from_water_vapor	s-1		
tendency_of_mass_fraction_of_stratiform_cloud_ice_in_air_due_to_homogeneous_nucleation	s-1		
tendency_of_mass_fraction_of_stratiform_cloud_ice_in_air_due_to_icefall	s-1		
tendency_of_mass_fraction_of_stratiform_cloud_ice_in_air_due_to_melting_to_cloud_liquid_water
alias: tendency_of_mass_fraction_of_stratiform_cloud_ice_in_air_due_to_melting_to_cloud_liquid
s-1		
tendency_of_mass_fraction_of_stratiform_cloud_ice_in_air_due_to_melting_to_rain	s-1		
tendency_of_mass_fraction_of_stratiform_cloud_ice_in_air_due_to_riming_from_cloud_liquid_water
alias: tendency_of_mass_fraction_of_stratiform_cloud_ice_in_air_due_to_riming_from_cloud_liquid
s-1		
tendency_of_mass_fraction_of_stratiform_cloud_ice_in_air_due_to_riming_from_rain	s-1		
tendency_of_mass_fraction_of_stratiform_cloud_liquid_water_in_air	s-1		
tendency_of_mass_fraction_of_stratiform_cloud_liquid_water_in_air_due_to_accretion_to_rain	s-1		
tendency_of_mass_fraction_of_stratiform_cloud_liquid_water_in_air_due_to_accretion_to_snow	s-1		
tendency_of_mass_fraction_of_stratiform_cloud_liquid_water_in_air_due_to_advection	s-1		
tendency_of_mass_fraction_of_stratiform_cloud_liquid_water_in_air_due_to_autoconversion	s-1		
tendency_of_mass_fraction_of_stratiform_cloud_liquid_water_in_air_due_to_bergeron_findeisen_process_to_cloud_ice	s-1		
tendency_of_mass_fraction_of_stratiform_cloud_liquid_water_in_air_due_to_boundary_layer_mixing	s-1		
tendency_of_mass_fraction_of_stratiform_cloud_liquid_water_in_air_due_to_cloud_microphysics	s-1		
tendency_of_mass_fraction_of_stratiform_cloud_liquid_water_in_air_due_to_condensation_and_evaporation	s-1		
tendency_of_mass_fraction_of_stratiform_cloud_liquid_water_in_air_due_to_condensation_and_evaporation_from_boundary_layer_mixing	s-1		
tendency_of_mass_fraction_of_stratiform_cloud_liquid_water_in_air_due_to_condensation_and_evaporation_from_convection	s-1		
tendency_of_mass_fraction_of_stratiform_cloud_liquid_water_in_air_due_to_condensation_and_evaporation_from_longwave_heating	s-1		
tendency_of_mass_fraction_of_stratiform_cloud_liquid_water_in_air_due_to_condensation_and_evaporation_from_pressure_change	s-1		
tendency_of_mass_fraction_of_stratiform_cloud_liquid_water_in_air_due_to_condensation_and_evaporation_from_shortwave_heating	s-1		
tendency_of_mass_fraction_of_stratiform_cloud_liquid_water_in_air_due_to_condensation_and_evaporation_from_turbulence	s-1		
tendency_of_mass_fraction_of_stratiform_cloud_liquid_water_in_air_due_to_convective_detrainment	s-1		
tendency_of_mass_fraction_of_stratiform_cloud_liquid_water_in_air_due_to_heterogeneous_nucleation	s-1		
tendency_of_mass_fraction_of_stratiform_cloud_liquid_water_in_air_due_to_homogeneous_nucleation	s-1		
tendency_of_mass_fraction_of_stratiform_cloud_liquid_water_in_air_due_to_melting_from_cloud_ice	s-1		
tendency_of_mass_fraction_of_stratiform_cloud_liquid_water_in_air_due_to_riming	s-1		
tendency_of_middle_atmosphere_moles_of_carbon_monoxide
alias: tendency_of_moles_of_carbon_monoxide_in_middle_atmosphere
mol s-1		
tendency_of_middle_atmosphere_moles_of_hcc140a
alias: tendency_of_moles_of_hcc140a_in_middle_atmosphere
mol s-1		
tendency_of_middle_atmosphere_moles_of_methane
alias: tendency_of_moles_of_methane_in_middle_atmosphere
mol s-1		
tendency_of_middle_atmosphere_moles_of_methyl_bromide
alias: tendency_of_moles_of_methyl_bromide_in_middle_atmosphere
mol s-1		
tendency_of_middle_atmosphere_moles_of_methyl_chloride
alias: tendency_of_moles_of_methyl_chloride_in_middle_atmosphere
mol s-1		
tendency_of_middle_atmosphere_moles_of_molecular_hydrogen
alias: tendency_of_moles_of_molecular_hydrogen_in_middle_atmosphere
mol s-1		
tendency_of_mole_concentration_of_aragonite_expressed_as_carbon_in_sea_water_due_to_biological_production	mol m-3 s-1		
tendency_of_mole_concentration_of_aragonite_expressed_as_carbon_in_sea_water_due_to_dissolution	mol m-3 s-1		
tendency_of_mole_concentration_of_calcite_expressed_as_carbon_in_sea_water_due_to_biological_production	mol m-3 s-1		
tendency_of_mole_concentration_of_calcite_expressed_as_carbon_in_sea_water_due_to_dissolution	mol m-3 s-1		
tendency_of_mole_concentration_of_dissolved_inorganic_carbon_in_sea_water_due_to_biological_processes	mol m-3 s-1		
tendency_of_mole_concentration_of_dissolved_inorganic_iron_in_sea_water_due_to_biological_processes	mol m-3 s-1		
tendency_of_mole_concentration_of_dissolved_inorganic_nitrogen_in_sea_water_due_to_biological_processes	mol m-3 s-1		
tendency_of_mole_concentration_of_dissolved_inorganic_phosphorus_in_sea_water_due_to_biological_processes
alias: tendency_of_mole_concentration_of_dissolved_inorganic_phosphate_in_sea_water_due_to_biological_processes
mol m-3 s-1		
tendency_of_mole_concentration_of_dissolved_inorganic_silicon_in_sea_water_due_to_biological_processes
alias: tendency_of_mole_concentration_of_dissolved_inorganic_silicate_in_sea_water_due_to_biological_processes
mol m-3 s-1		
tendency_of_mole_concentration_of_dissolved_iron_in_sea_water_due_to_dissolution_from_inorganic_particles	mol m-3 s-1		
tendency_of_mole_concentration_of_dissolved_iron_in_sea_water_due_to_grazing_of_phytoplankton	mol m-3 s-1		
tendency_of_mole_concentration_of_dissolved_iron_in_sea_water_due_to_scavenging_by_inorganic_particles	mol m-3 s-1		
tendency_of_mole_concentration_of_iron_in_sea_water_due_to_biological_production	mol m-3 s-1		
tendency_of_mole_concentration_of_particulate_organic_matter_expressed_as_carbon_in_sea_water_due_to_net_primary_production	mol m-3 s-1		
tendency_of_mole_concentration_of_particulate_organic_matter_expressed_as_carbon_in_sea_water_due_to_net_primary_production_by_calcareous_phytoplankton	mol m-3 s-1		
tendency_of_mole_concentration_of_particulate_organic_matter_expressed_as_carbon_in_sea_water_due_to_net_primary_production_by_diatoms	mol m-3 s-1		
tendency_of_mole_concentration_of_particulate_organic_matter_expressed_as_carbon_in_sea_water_due_to_net_primary_production_by_diazotrophs	mol m-3 s-1		
tendency_of_mole_concentration_of_particulate_organic_matter_expressed_as_carbon_in_sea_water_due_to_net_primary_production_by_miscellaneous_phytoplankton	mol m-3 s-1		
tendency_of_mole_concentration_of_particulate_organic_matter_expressed_as_carbon_in_sea_water_due_to_net_primary_production_by_picophytoplankton	mol m-3 s-1		
tendency_of_mole_concentration_of_particulate_organic_matter_expressed_as_carbon_in_sea_water_due_to_nitrate_utilization	mol m-3 s-1		
tendency_of_mole_concentration_of_silicon_in_sea_water_due_to_biological_production	mol m-3 s-1		
tendency_of_northward_wind	m s-2	tnmmvtot	
tendency_of_northward_wind_due_to_advection	m s-2		
tendency_of_northward_wind_due_to_convection	m s-2	tnmmvc	
tendency_of_northward_wind_due_to_diffusion	m s-2		
tendency_of_northward_wind_due_to_gravity_wave_drag	m s-2	tnmmvgwd	
tendency_of_ocean_barotropic_streamfunction	m3 s-2		
tendency_of_ocean_eddy_kinetic_energy_content_due_to_bolus_transport	W m-2		
tendency_of_ocean_mole_content_of_aragonite_expressed_as_carbon_due_to_biological_production	mol m-2 s-1		
tendency_of_ocean_mole_content_of_calcite_expressed_as_carbon_due_to_biological_production	mol m-2 s-1		
tendency_of_ocean_mole_content_of_carbon_due_to_runoff_and_sediment_dissolution	mol m-2 s-1		
tendency_of_ocean_mole_content_of_carbon_due_to_sedimentation	mol m-2 s-1		
tendency_of_ocean_mole_content_of_dissolved_inorganic_carbon	mol m-2 s-1		
tendency_of_ocean_mole_content_of_dissolved_inorganic_carbon_due_to_biological_processes	mol m-2 s-1		
tendency_of_ocean_mole_content_of_dissolved_inorganic_iron	mol m-2 s-1		
tendency_of_ocean_mole_content_of_dissolved_inorganic_iron_due_to_biological_processes	mol m-2 s-1		
tendency_of_ocean_mole_content_of_dissolved_inorganic_nitrogen	mol m-2 s-1		
tendency_of_ocean_mole_content_of_dissolved_inorganic_nitrogen_due_to_biological_processes	mol m-2 s-1		
tendency_of_ocean_mole_content_of_dissolved_inorganic_phosphorus	mol m-2 s-1		
tendency_of_ocean_mole_content_of_dissolved_inorganic_phosphorus_due_to_biological_processes	mol m-2 s-1		
tendency_of_ocean_mole_content_of_dissolved_inorganic_silicon	mol m-2 s-1		
tendency_of_ocean_mole_content_of_dissolved_inorganic_silicon_due_to_biological_processes	mol m-2 s-1		
tendency_of_ocean_mole_content_of_elemental_nitrogen_due_to_denitrification_and_sedimentation	mol m-2 s-1		
tendency_of_ocean_mole_content_of_elemental_nitrogen_due_to_deposition_and_fixation_and_runoff	mol m-2 s-1		
tendency_of_ocean_mole_content_of_elemental_nitrogen_due_to_fixation	mol m-2 s-1		
tendency_of_ocean_mole_content_of_iron_due_to_biological_production	mol m-2 s-1		
tendency_of_ocean_mole_content_of_iron_due_to_deposition_and_runoff_and_sediment_dissolution	mol m-2 s-1		
tendency_of_ocean_mole_content_of_iron_due_to_sedimentation	mol m-2 s-1		
tendency_of_ocean_mole_content_of_silicon_due_to_biological_production	mol m-2 s-1		
tendency_of_ocean_potential_energy_content	W m-2		
tendency_of_ocean_potential_energy_content_due_to_background	W m-2		
tendency_of_ocean_potential_energy_content_due_to_tides	W m-2		
tendency_of_potential_energy_content_of_atmosphere_layer_due_to_advection	W m-2		
tendency_of_potential_energy_content_of_ocean_layer_due_to_convection	W m-2		
tendency_of_potential_energy_content_of_ocean_layer_due_to_diffusion	W m-2		
tendency_of_sea_ice_amount_due_to_basal_melting	kg m-2 s-1		
tendency_of_sea_ice_amount_due_to_congelation_ice_accumulation	kg m-2 s-1		
tendency_of_sea_ice_amount_due_to_frazil_ice_accumulation_in_leads	kg m-2 s-1		
tendency_of_sea_ice_amount_due_to_lateral_growth_of_ice_floes	kg m-2 s-1		
tendency_of_sea_ice_amount_due_to_snow_conversion	kg m-2 s-1		
tendency_of_sea_ice_amount_due_to_surface_melting	kg m-2 s-1		
tendency_of_sea_ice_area_fraction_due_to_dynamics	s-1		
tendency_of_sea_ice_area_fraction_due_to_ridging	s-1		
tendency_of_sea_ice_area_fraction_due_to_thermodynamics	s-1		
tendency_of_sea_ice_thickness_due_to_dynamics	m s-1		
tendency_of_sea_ice_thickness_due_to_thermodynamics	m s-1		97
tendency_of_sea_surface_height_above_sea_level	m year-1		
tendency_of_sea_water_alkalinity_expressed_as_mole_equivalent_due_to_biological_processes	mol m-3 s-1		
tendency_of_sea_water_salinity	1e-3 s-1		
tendency_of_sea_water_salinity_due_to_advection	1e-3 s-1		
tendency_of_sea_water_salinity_due_to_bolus_advection	1e-3 s-1		
tendency_of_sea_water_salinity_due_to_horizontal_mixing	1e-3 s-1		
tendency_of_sea_water_salinity_due_to_sea_ice_thermodynamics	1e-3 s-1		
tendency_of_sea_water_salinity_due_to_vertical_mixing	1e-3 s-1		
tendency_of_sea_water_temperature	K s-1		
tendency_of_sea_water_temperature_due_to_advection	K s-1		
tendency_of_sea_water_temperature_due_to_bolus_advection	K s-1		
tendency_of_sea_water_temperature_due_to_horizontal_mixing	K s-1		
tendency_of_sea_water_temperature_due_to_vertical_mixing	K s-1		
tendency_of_specific_humidity	s-1		
tendency_of_specific_humidity_due_to_advection	s-1		
tendency_of_specific_humidity_due_to_convection	s-1	tnmrc	
tendency_of_specific_humidity_due_to_diffusion	s-1		
tendency_of_specific_humidity_due_to_model_physics	s-1	tnmrd	
tendency_of_specific_humidity_due_to_stratiform_cloud_and_precipitation_and_boundary_layer_mixing	K s-1		
tendency_of_specific_humidity_due_to_stratiform_precipitation
alias: tendency_of_specific_humidity_due_to_large_scale_precipitation
s-1		
tendency_of_surface_air_pressure	Pa s-1		E158
tendency_of_surface_snow_amount	kg m-2 s-1		
tendency_of_troposphere_moles_of_carbon_monoxide
alias: tendency_of_moles_of_carbon_monoxide_in_troposphere
mol s-1		
tendency_of_troposphere_moles_of_hcc140a
alias: tendency_of_moles_of_hcc140a_in_troposphere
mol s-1		
tendency_of_troposphere_moles_of_hcfc22
alias: tendency_of_moles_of_hcfc22_in_troposphere
mol s-1		
tendency_of_troposphere_moles_of_methane
alias: tendency_of_moles_of_methane_in_troposphere
mol s-1		
tendency_of_troposphere_moles_of_methyl_bromide
alias: tendency_of_moles_of_methyl_bromide_in_troposphere
mol s-1		
tendency_of_troposphere_moles_of_methyl_chloride
alias: tendency_of_moles_of_methyl_chloride_in_troposphere
mol s-1		
tendency_of_troposphere_moles_of_molecular_hydrogen
alias: tendency_of_moles_of_molecular_hydrogen_in_troposphere
mol s-1		
tendency_of_upward_air_velocity	m s-2		
tendency_of_upward_air_velocity_due_to_advection	m s-2		
tendency_of_wind_speed_due_to_convection	m s-2		
tendency_of_wind_speed_due_to_gravity_wave_drag	m s-2		
thermal_energy_content_of_surface_snow
alias: snow_thermal_energy_content
J m-2		
thermodynamic_phase_of_cloud_water_particles_at_cloud_top	1		
thickness_of_convective_rainfall_amount	m		
thickness_of_convective_snowfall_amount	m		
thickness_of_liquid_water_cloud	m		
thickness_of_rainfall_amount	m		
thickness_of_snowfall_amount	m		
thickness_of_stratiform_rainfall_amount
alias: thickness_of_large_scale_rainfall_amount
m		
thickness_of_stratiform_snowfall_amount
alias: thickness_of_large_scale_snowfall_amount
m		
thunderstorm_probability	1		60
time	s	time	
time_sample_difference_due_to_collocation	s		
toa_adjusted_longwave_forcing	W m-2		
toa_adjusted_radiative_forcing	W m-2		
toa_adjusted_shortwave_forcing	W m-2		
toa_bidirectional_reflectance	1		
toa_brightness_temperature	K		
toa_brightness_temperature_assuming_clear_sky	K		
toa_brightness_temperature_bias_at_standard_scene_due_to_intercalibration	K		
toa_brightness_temperature_of_standard_scene	K		
toa_cloud_radiative_effect	W m-2		
toa_incoming_shortwave_flux	W m-2	rsdt	
toa_instantaneous_longwave_forcing	W m-2		
toa_instantaneous_radiative_forcing	W m-2		
toa_instantaneous_shortwave_forcing	W m-2		
toa_longwave_cloud_radiative_effect	W m-2		
toa_net_downward_longwave_flux	W m-2		
toa_net_downward_longwave_flux_assuming_clear_sky	W m-2		
toa_net_downward_radiative_flux	W m-2		
toa_net_downward_shortwave_flux	W m-2	rst	
toa_net_downward_shortwave_flux_assuming_clear_sky	W m-2		
toa_net_upward_longwave_flux	W m-2		
toa_net_upward_longwave_flux_assuming_clear_sky	W m-2		
toa_net_upward_shortwave_flux	W m-2		113 E178
toa_outgoing_longwave_flux	W m-2	rlut	114 E179
toa_outgoing_longwave_flux_assuming_clear_sky	W m-2	rlutcs	
toa_outgoing_radiance_per_unit_wavelength	W m-2 sr-1 m-1		
toa_outgoing_radiance_per_unit_wavenumber	W m-2 sr-1 (m-1)-1		
toa_outgoing_radiance_per_unit_wavenumber_mean_within_collocation_scene	W m-2 sr-1 (m-1)-1		
toa_outgoing_radiance_per_unit_wavenumber_mean_within_collocation_target	W m-2 sr-1 (m-1)-1		
toa_outgoing_radiance_per_unit_wavenumber_stdev_within_collocation_scene	W m-2 sr-1 (m-1)-1		
toa_outgoing_radiance_per_unit_wavenumber_stdev_within_collocation_target	W m-2 sr-1 (m-1)-1		
toa_outgoing_shortwave_flux	W m-2	rsut	
toa_outgoing_shortwave_flux_assuming_clear_sky	W m-2	rsutcs	
toa_shortwave_cloud_radiative_effect	W m-2		
transpiration_amount	kg m-2		
transpiration_flux	kg m-2 s-1		
tropopause_adjusted_longwave_forcing	W m-2		
tropopause_adjusted_radiative_forcing	W m-2		
tropopause_adjusted_shortwave_forcing	W m-2		
tropopause_air_pressure	Pa		
tropopause_air_temperature	K		
tropopause_altitude	m		
tropopause_downwelling_longwave_flux	W m-2		
tropopause_instantaneous_longwave_forcing	W m-2		
tropopause_instantaneous_radiative_forcing	W m-2		
tropopause_instantaneous_shortwave_forcing	W m-2		
tropopause_net_downward_longwave_flux	W m-2		
tropopause_net_downward_shortwave_flux	W m-2		
tropopause_upwelling_shortwave_flux	W m-2		
troposphere_mole_content_of_bromine_monoxide	mol m-2		
troposphere_mole_content_of_formaldehyde	mol m-2		
troposphere_mole_content_of_glyoxal	mol m-2		
troposphere_mole_content_of_iodine_monoxide	mol m-2		
troposphere_mole_content_of_nitrogen_dioxide	mol m-2		
troposphere_mole_content_of_ozone	mol m-2		
troposphere_mole_content_of_sulfur_dioxide	mol m-2		
upward_air_velocity	m s-1		40
upward_dry_static_energy_flux_due_to_diffusion	W m-2		
upward_eastward_momentum_flux_in_air_due_to_nonorographic_eastward_gravity_waves
alias: upward_flux_of_eastward_momentum_due_to_nonorographic_eastward_gravity_waves
Pa		
upward_eastward_momentum_flux_in_air_due_to_nonorographic_westward_gravity_waves
alias: upward_flux_of_eastward_momentum_due_to_nonorographic_westward_gravity_waves
Pa		
upward_eastward_momentum_flux_in_air_due_to_orographic_gravity_waves
alias: upward_flux_of_eastward_momentum_due_to_orographic_gravity_waves
Pa		
upward_eastward_stress_at_sea_ice_base	Pa		
upward_eliassen_palm_flux_in_air
alias: upward_eliassen_palm_flux
m3 s-2		
upward_geothermal_heat_flux_at_sea_floor	W m-2		
upward_heat_flux_at_ground_level_in_snow	W m-2		
upward_heat_flux_at_ground_level_in_soil	W m-2		
upward_heat_flux_in_air	W m-2		
upward_heat_flux_in_sea_water_due_to_convection	W m-2		
upward_latent_heat_flux_in_air	W m-2		
upward_mass_flux_of_air	kg m-2 s-1		
upward_northward_stress_at_sea_ice_base	Pa		
upward_ocean_mass_transport	kg s-1		
upward_sea_ice_basal_heat_flux	W m-2		
upward_sea_water_velocity	m s-1		
upward_sensible_heat_flux_in_air	W m-2		
upward_water_vapor_flux_in_air	kg m-2 s-1		
upward_water_vapor_flux_in_air_due_to_diffusion	kg m-2 s-1		
upward_x_stress_at_sea_ice_base	Pa		
upward_y_stress_at_sea_ice_base	Pa		
upwelling_longwave_flux_in_air	W m-2		
upwelling_longwave_flux_in_air_assuming_clear_sky	W m-2		
upwelling_longwave_radiance_in_air	W m-2 sr-1		
upwelling_radiance_per_unit_wavelength_in_air
alias: upwelling_spectral_radiance_in_air
W m-2 m-1 sr-1		
upwelling_radiative_flux_per_unit_wavelength_in_air
alias: upwelling_spectral_radiative_flux_in_air
W m-2 m-1		
upwelling_radiative_flux_per_unit_wavelength_in_sea_water
alias: upwelling_spectral_radiative_flux_in_sea_water
W m-2 m-1		
upwelling_shortwave_flux_in_air	W m-2		
upwelling_shortwave_flux_in_air_assuming_clear_sky	W m-2		
upwelling_shortwave_radiance_in_air	W m-2 sr-1		
vegetation_area_fraction	1		87
vegetation_carbon_content	kg m-2		
vertical_component_of_ocean_xy_tracer_diffusivity	m2 s-1		
virtual_salt_flux_correction	kg m-2 s-1		
virtual_salt_flux_into_sea_water	kg m-2 s-1		
virtual_salt_flux_into_sea_water_due_to_evaporation	kg m-2 s-1		
virtual_salt_flux_into_sea_water_due_to_newtonian_relaxation	kg m-2 s-1		
virtual_salt_flux_into_sea_water_due_to_rainfall	kg m-2 s-1		
virtual_salt_flux_into_sea_water_due_to_sea_ice_thermodynamics	kg m-2 s-1		
virtual_salt_flux_into_sea_water_from_rivers	kg m-2 s-1		
virtual_temperature	K		12
visibility_in_air	m		20
volume_absorption_coefficient_of_radiative_flux_in_sea_water	m-1		
volume_absorption_coefficient_of_radiative_flux_in_sea_water_due_to_dissolved_organic_matter	m-1		
volume_attenuated_backwards_scattering_function_in_air	m-1 sr-1		
volume_attenuated_backwards_scattering_function_in_air_assuming_no_aerosol_or_cloud	m-1 sr-1		
volume_attenuation_coefficient_of_downwelling_radiative_flux_in_sea_water	m-1		
volume_backwards_scattering_coefficient_of_radiative_flux_in_sea_water	m-1		
volume_beam_attenuation_coefficient_of_radiative_flux_in_sea_water	m-1		
volume_extinction_coefficient_in_air_due_to_ambient_aerosol	m -1		
volume_fraction_of_clay_in_soil	1		
volume_fraction_of_condensed_water_in_soil
alias: volume_fraction_of_water_in_soil
1		
volume_fraction_of_condensed_water_in_soil_at_critical_point
alias: volume_fraction_of_water_in_soil_at_critical_point
1		
volume_fraction_of_condensed_water_in_soil_at_field_capacity
alias: volume_fraction_of_water_in_soil_at_field_capacity
1		
volume_fraction_of_condensed_water_in_soil_at_wilting_point
alias: volume_fraction_of_water_in_soil_at_wilting_point
1		
volume_fraction_of_condensed_water_in_soil_pores	1		
volume_fraction_of_frozen_water_in_soil	1		
volume_fraction_of_oxygen_in_sea_water	1		
volume_fraction_of_sand_in_soil	1		
volume_fraction_of_silt_in_soil	1		
volume_mixing_ratio_of_oxygen_at_stp_in_sea_water	1		
volume_scattering_coefficient_of_radiative_flux_in_sea_water	m-1		
volume_scattering_function_of_radiative_flux_in_sea_water	m-1 sr-1		
water_evaporation_amount	kg m-2		57
water_evaporation_amount_from_canopy
alias: water_evaporation_amount_from_canopy_where_land
kg m-2		
water_evaporation_flux
alias: water_evaporation_flux_where_sea_ice
kg m-2 s-1	evspsbl	
water_evaporation_flux_from_canopy
alias: water_evaporation_flux_from_canopy_where_land
kg m-2 s-1		
water_evaporation_flux_from_soil	kg m-2 s-1		
water_flux_correction	kg m-2 s-1		
water_flux_into_sea_water
alias: water_flux_into_ocean
kg m-2 s-1	wfo	
water_flux_into_sea_water_due_to_sea_ice_thermodynamics	kg m-2 s-1		
water_flux_into_sea_water_from_icebergs	kg m-2 s-1		
water_flux_into_sea_water_from_rivers
alias: water_flux_into_ocean_from_rivers
kg m-2 s-1		
water_flux_into_sea_water_from_rivers_and_surface_downward_water_flux	kg m-2 s-1		
water_flux_into_sea_water_without_flux_correction	kg m-2 s-1		
water_flux_out_of_sea_ice_and_sea_water	kg m-2 s-1		
water_flux_out_of_sea_water	kg m-2 s-1		
water_flux_out_of_sea_water_due_to_newtonian_relaxation	kg m-2 s-1		
water_flux_out_of_sea_water_due_to_sea_ice_thermodynamics	kg m-2 s-1		
water_potential_evaporation_amount	kg m-2		
water_potential_evaporation_flux	kg m-2 s-1		
water_sublimation_flux	kg m-2 s-1		
water_surface_height_above_reference_datum	m		
water_surface_reference_datum_altitude	m		
water_vapor_partial_pressure_in_air
alias: water_vapor_pressure
Pa		55
water_vapor_saturation_deficit_in_air
alias: water_vapor_saturation_deficit
Pa		56
water_volume_transport_into_sea_water_from_rivers
alias: water_volume_transport_into_ocean_from_rivers
m3 s-1		
wave_frequency
alias: sea_surface_wave_frequency
s-1		
wet_bulb_temperature	K		
wind_from_direction	degree		31
wind_mixing_energy_flux_into_sea_water
alias: wind_mixing_energy_flux_into_ocean
W m-2		126
wind_speed	m s-1		32
wind_speed_of_gust	m s-1		
wind_speed_shear	s-1		N136
wind_to_direction	degree		
wood_carbon_content	kg m-2		
wood_debris_carbon_content	kg m-2		
x_derivative_of_ocean_rigid_lid_pressure	Pa m-1		
x_heat_flux_in_sea_water_due_to_advection	W m-2		
x_wind
alias: grid_eastward_wind
m s-1		
y_derivative_of_ocean_rigid_lid_pressure	Pa m-1		
y_heat_flux_in_sea_water_due_to_advection	W m-2		
y_wind
alias: grid_northward_wind
m s-1		
zenith_angle	degree